an yuzhi	China:Capital Med Univ, Beijing Tongren Hosp, Beijing Tongren Eye Ctr, Beijing Inst Ophthalmol, Beijing,Peoples R China. Capital Medical University	GRAEFES ARCHIVE FOR CLINICAL AND EXPERIMENTAL OPHTHALMOLOGY	Epithelial tumors of the lacrimal gland in the Chinese: a clinicopathologic study of 298 patients
auyeung kinchor	China:Chinese Univ Hong Kong, Dept Ophthalmol & Visual Sci, Hong Kong, Hong Kong,Peoples R China. Chinese University of Hong Kong	OPHTHALMIC PLASTIC AND RECONSTRUCTIVE SURGERY	Late-onset occult cerebrospinal fluid leakage after orbital exenteration
bao weimin	China:Fudan Univ, Dept Neurosurg, Huashan Hosp, Shanghai 200433,Peoples R China. Fudan University	JOURNAL OF NEURO-OPHTHALMOLOGY	Ectopic Pituitary Adenoma in the Spheno-Orbital Region
bi xiaoping	China:Shanghai Jiao Tong Univ, Sch Med, Peoples Hosp 9, Dept Ophthalmol, Shanghai 200011,Peoples R China. Shanghai Jiao Tong University	INVESTIGATIVE OPHTHALMOLOGY & VISUAL SCIENCE	In Vivo Efficacy of Bone Marrow Stromal Cells Coated with Beta-Tricalcium Phosphate for the Reconstruction of Orbital Defects in Canines
cai changsi	China:Shanghai Jiao Tong Univ, Dept Biomed Engn, Sch Life Sci & Biotechnol, Shanghai 200240,Peoples R China. Shanghai Jiao Tong University	INVESTIGATIVE OPHTHALMOLOGY & VISUAL SCIENCE	Spatiotemporal Properties of Multipeaked Electrically Evoked Potentials Elicited by Penetrative Optic Nerve Stimulation in Rabbits
cai chunquan	China:Tianjin Med Univ, Dept Surg, Tianjin Childrens Hosp, Inst Pediat Clin, Tianjin 300203,Peoples R China. Tianjin Medical University	BRITISH JOURNAL OF OPHTHALMOLOGY	Grey and white matter changes in children with monocular amblyopia: voxel-based morphometry and diffusion tensor imaging study
cai jianhao	China:Sun Yat Sen Univ, Zhongshan Ophthal Ctr, Guangzhou 510060, Guangdong,Peoples R China. Sun Yat Sen University	AMERICAN JOURNAL OF OPHTHALMOLOGY	A Modified Evisceration Technique with Scleral Quadrisection and Porous Polyethylene Implantation
cai jiping	China:Second Mil Med Univ, Shanghai Changzheng Hosp, Dept Ophthalmol, Shanghai 200003,Peoples R China. Second Military Medical University	INVESTIGATIVE OPHTHALMOLOGY & VISUAL SCIENCE	The Expression of Intercellular Adhesion Molecule-1 Induced by CD40-CD40L Ligand Signaling in Orbital Fibroblasts in Patients with Graves' Ophthalmopathy
cai jiping	China:Second Mil Med Univ, Shanghai Changzheng Hosp, Dept Ophthalmol, Shanghai 200003,Peoples R China. Second Military Medical University	OPHTHALMOLOGICA	The use of orbital radiotherapy for Graves' ophthalmopathy: Quantitative review of the evidence
cai xiaoling	China:Peking Univ, Peoples Hosp, Dept Endocrinol & Metab, Beijing 100871,Peoples R China. Peking University	PLOS ONE	Age at Diagnosis and C-Peptide Level Are Associated with Diabetic Retinopathy in Chinese
cao he	China:Shantou Univ, Coll Med, Injury Prevent Res Ctr, Shantou, Guangdong,Peoples R China. Shantou University	PLOS ONE	Epidemiology of Pediatric Ocular Trauma in the Chaoshan Region, China, 2001-2010
cao pengjia	China:Shanghai Jiao Tong Univ, Dept Biomed Engn, Inst Laser Med & Biophoton, Shanghai 200240,Peoples R China. Shanghai Jiao Tong University	GRAEFES ARCHIVE FOR CLINICAL AND EXPERIMENTAL OPHTHALMOLOGY	Intraorbital optic nerve stimulation with penetrating electrodes: in vivo electrophysiology study in rabbits
cao pengjia	China:Shanghai Jiao Tong Univ, Dept Biomed Engn, Inst Laser Med & Biophoton, Shanghai 200240,Peoples R China. Shanghai Jiao Tong University	INVESTIGATIVE OPHTHALMOLOGY & VISUAL SCIENCE	Spatiotemporal Properties of Multipeaked Electrically Evoked Potentials Elicited by Penetrative Optic Nerve Stimulation in Rabbits
chai xinyu	China:Shanghai Jiao Tong Univ, Dept Biomed Engn, Inst Laser Med & Biophoton, Shanghai 200240,Peoples R China. Shanghai Jiao Tong University	GRAEFES ARCHIVE FOR CLINICAL AND EXPERIMENTAL OPHTHALMOLOGY	Intraorbital optic nerve stimulation with penetrating electrodes: in vivo electrophysiology study in rabbits
chai xinyu	China:Shanghai Jiao Tong Univ, Dept Biomed Engn, Inst Laser Med & Biophoton, Shanghai 200240,Peoples R China. Shanghai Jiao Tong University	INVESTIGATIVE OPHTHALMOLOGY & VISUAL SCIENCE	Spatiotemporal Properties of Multipeaked Electrically Evoked Potentials Elicited by Penetrative Optic Nerve Stimulation in Rabbits
chan clementwainang	China:Tung Wah Eastern Hosp, Dept Ophthalmol, Hong Kong, Hong Kong,Peoples R China. 	INTERNATIONAL JOURNAL OF OPHTHALMOLOGY	Clinicopathological survey of 23 patients with lacrimal fossa lesions in Hong Kong
chan edwin	China:Tung Wah Eastern Hosp, Dept Ophthalmol, Hong Kong, Hong Kong,Peoples R China. 	INTERNATIONAL JOURNAL OF OPHTHALMOLOGY	Clinicopathological survey of 23 patients with lacrimal fossa lesions in Hong Kong
chang qinglin	China:Capital Med Univ, Beijing Tongren Hosp, Beijing Tongren Med Imaging Ctr, Beijing,Peoples R China. Capital Medical University	JOURNAL OF AAPOS	Diagnosis and surgical treatment of unilateral restrictive hypotropia and esotropia
chang qinglin	China:Capital Med Univ, Beijing Tongren Hosp, Beijing Tongren Med Imaging Ctr, Beijing,Peoples R China. Capital Medical University	AMERICAN JOURNAL OF OPHTHALMOLOGY	Digital Evaluation of Orbital Development in Chinese Children With Congenital Microphthalmia
chen ben	China:Wenzhou Med Coll, Affiliated Eye Hosp, Wenzhou City 325027, Zhejiang,Peoples R China. Wenzhou Medical University	OPHTHALMOLOGY	Endoscopic Transcaruncular Repair of Large Medial Orbital Wall Fractures Near the Orbital Apex
chen ben	China:Wenzhou Med Coll, Affiliated Eye Hosp, Wenzhou City 325027, Zhejiang,Peoples R China. Wenzhou Medical University	AMERICAN JOURNAL OF OPHTHALMOLOGY	Endoscopic Transethmoidal Approach with or without Medial Rectus Detachment for Orbital Apical Cavernous Hemangiomas
chen jing	China:Sichuan Univ, Dept Neurosurg, W China Hosp, Chengdu 610041, Sichuan Provinc,Peoples R China. Sichuan University	MOLECULAR VISION	Retinal whole genome microarray analysis and early morphological changes in the optic nerves of monkeys after an intraorbital nerve irradiated injury
chen jun	China:Sichuan Univ, Dept Ophthalmol, W China Hosp, Chengdu 610041, Sichuan Provinc,Peoples R China. Sichuan University	MOLECULAR VISION	Retinal whole genome microarray analysis and early morphological changes in the optic nerves of monkeys after an intraorbital nerve irradiated injury
chen lukui	China:Xiamen Univ, Dept Neurosurg, Zhongshan Hosp, Xiamen,Peoples R China. Xiamen University	CLINICAL AND EXPERIMENTAL OPHTHALMOLOGY	Transnasal transsphenoid approach: a minimally invasive approach for removal of cavernous haemangiomas located at inferomedial part of orbital apex
chen mengyu	China:GuangZhou Med Univ, Key Lab Neurogenet & Channelopathies Guangdong Pr, Guangzhou, Guangdong,Peoples R China. Guangzhou Medical University	PLOS ONE	Serum Thyroid-Stimulating Hormone and Anti-Thyroglobulin Antibody Are Independently Associated with Lesions in Spinal Cord in Central Nervous System Demyelinating Diseases
chen minli	China:Guangxi Med Univ, Dept Geriatr & Gerontol, Affiliated Hosp 1, Nanning,Peoples R China. Guangxi Medical University	PLOS ONE	Association between the IL1B (-511), IL1B (+3954), IL1RN (VNTR) Polymorphisms and Graves' Disease Risk: A Meta-Analysis of 11 Case-Control Studies
chen ping	China:Shanghai Jiao Tong Univ, Sch Med, Peoples Hosp 9, Dept Ophthalmol, Shanghai 200011,Peoples R China. Shanghai Jiao Tong University	EXPERIMENTAL EYE RESEARCH	Insulin-like growth factor 1 promotes the proliferation and adipogenesis of orbital adipose-derived stromal cells in thyroid-associated ophthalmopathy
chen rongxin	China:Sun Yat Sen Univ, Zhongshan Ophthalm Ctr, State Key Lab Ophthalmol, Guangzhou 510060, Guangdong,Peoples R China. Sun Yat Sen University	CURRENT EYE RESEARCH	Vision-Related Quality of Life Tends to be More Severely Impaired in Patients with Dysthyroid Optic Neuropathy
chen tao	China:Capital Med Univ, Beijing Tongren Hosp, Beijing Tongren Eye Ctr, Beijing Ophthalmol & Visual Sci Key Lab, Beijing,Peoples R China. Capital Medical University	JOURNAL OF AAPOS	Diagnosis and surgical treatment of unilateral restrictive hypotropia and esotropia
chen wei	China:Huazhong Univ Sci & Technol, Tongji Med Coll, Tongji Hosp, Dept Ophthalmol, Wuhan 430074,Peoples R China. Huazhong University of Science & Technology	OPHTHALMIC PLASTIC AND RECONSTRUCTIVE SURGERY	The Psychosocial Benefits of Secondary Hydroxyapatite Orbital Implant Insertion and Prosthesis Wearing for Patients With Anophthalmia
chen yingli	China:Peking Univ, Peoples Hosp, Dept Endocrinol & Metab, Beijing 100871,Peoples R China. Peking University	PLOS ONE	Age at Diagnosis and C-Peptide Level Are Associated with Diabetic Retinopathy in Chinese
chen zaoping	China:Fudan Univ, Dept Endocrinol & Metab, Shanghai Peoples Hosp 5, Shanghai 200433,Peoples R China. Fudan University	PLOS ONE	Decrease in Proportion of CD19(+)CD24(hi)CD27(+) B Cells and Impairment of Their Suppressive Function in Graves' Disease
cheng cheng	China:Chinese Univ Hong Kong, Dept Ophthalmol & Visual Sci, Hong Kong Eye Hosp, Kowloon, Hong Kong,Peoples R China. Chinese University of Hong Kong	OPHTHALMIC PLASTIC AND RECONSTRUCTIVE SURGERY	Surgical anatomy of the Chinese orbit
cheng cheng	China:Chinese Univ Hong Kong, Dept Ophthalmol & Visual Sci, Hong Kong Eye Hosp, Kowloon, Hong Kong,Peoples R China. Chinese University of Hong Kong	OPHTHALMIC PLASTIC AND RECONSTRUCTIVE SURGERY	Late-onset occult cerebrospinal fluid leakage after orbital exenteration
cheng jinwei	China:Second Mil Med Univ, Shanghai Changzheng Hosp, Dept Ophthalmol, Shanghai 200003,Peoples R China. Second Military Medical University	INVESTIGATIVE OPHTHALMOLOGY & VISUAL SCIENCE	The Expression of Intercellular Adhesion Molecule-1 Induced by CD40-CD40L Ligand Signaling in Orbital Fibroblasts in Patients with Graves' Ophthalmopathy
cheng jinwei	China:Second Mil Med Univ, Shanghai Changzheng Hosp, Dept Ophthalmol, Shanghai 200003,Peoples R China. Second Military Medical University	OPHTHALMOLOGICA	The use of orbital radiotherapy for Graves' ophthalmopathy: Quantitative review of the evidence
chiang chiang	China:Shantou Univ Med Coll, Joint Shantou Int Eye Ctr, Shantou,Peoples R China. 	INVESTIGATIVE OPHTHALMOLOGY & VISUAL SCIENCE	Association of CTLA-4 and IL-13 gene polymorphisms with Graves' disease and ophthalmopathy in Chinese children
chong chong	China:Chinese Univ Hong Kong, Dept Pediat, Kowloon, Hong Kong,Peoples R China. Chinese University of Hong Kong	INVESTIGATIVE OPHTHALMOLOGY & VISUAL SCIENCE	Association of CTLA-4 and IL-13 gene polymorphisms with Graves' disease and ophthalmopathy in Chinese children
chong chong	China:Univ Calif Los Angeles, David Geffen Sch Med, Jules Stein Eye Inst, Los Angeles, CA 90095 USA. University of California Los AngelesUniversity of California System	OPHTHALMOLOGY	Rituximab Treatment of Patients with Severe, Corticosteroid-Resistant Thyroid-Associated Ophthalmopathy
chu yiwei	China:Fudan Univ, Biotherapy Res Ctr, Shanghai Med Coll, Shanghai 200433,Peoples R China. Fudan University	PLOS ONE	Decrease in Proportion of CD19(+)CD24(hi)CD27(+) B Cells and Impairment of Their Suppressive Function in Graves' Disease
cui bin	China:Chinese Acad Sci, Shanghai Inst Biol Sci, Inst Hlth Sci, Lab Endocrinol & Metab, Shanghai,Peoples R China. Chinese Academy of SciencesShanghai Institutes for Biological Sciences	PLOS ONE	Chemokine (C-C Motif) Ligand 20, a Potential Biomarker for Graves' Disease, Is Regulated by Osteopontin
dai yi	China:Shanghai Med Coll, Eye & ENT Hosp, Dept Ophthalmol & Vis Sci, Shanghai,Peoples R China. 	JOURNAL OF GLAUCOMA	Parapapillary Gamma Zone Hole
deng yuan	China:Shanghai Jiao Tong Univ, Sch Med, Peoples Hosp 9, Dept Ophthalmol, Shanghai 200011,Peoples R China. Shanghai Jiao Tong University	EXPERIMENTAL EYE RESEARCH	Insulin-like growth factor 1 promotes the proliferation and adipogenesis of orbital adipose-derived stromal cells in thyroid-associated ophthalmopathy
ding zhongxiang	China:Natl Univ Singapore, Yong Loo Lin Sch Med, Natl Univ Hlth Syst, Dept Diagnost Imaging, Singapore 117595, Singapore. National University of Singapore	PLOS ONE	Idiopathic Orbital Inflammation Syndrome with Retro-Orbital Involvement: A Retrospective Study of Eight Patients
dong fangtian	China:Beijing Union Med Coll Hosp, Peking Union Med Coll, Dept Ophthalmol, Beijing 100710,Peoples R China. Chinese Academy of Medical Sciences - Peking Union Medical College	EXPERIMENTAL EYE RESEARCH	Transthyretin Ala36Pro mutation in a Chinese pedigree of familial transthyretin amyloidosis with elevated vitreous and serum vascular endothelial growth factor
dong fangtian	China:Beijing Union Med Coll Hosp, Peking Union Med Coll, Dept Ophthalmol, Beijing 100710,Peoples R China. Chinese Academy of Medical Sciences - Peking Union Medical College	GRAEFES ARCHIVE FOR CLINICAL AND EXPERIMENTAL OPHTHALMOLOGY	Locally produced insulin-like growth factor-1 by orbital fibroblasts as implicative pathogenic factor rather than systemically circulated IGF-1 for patients with thyroid-associated ophthalmopathy
dong huiqing	China:Capital Med Univ, Dept Neurol, Xuanwu Hosp, Beijing,Peoples R China. Capital Medical University	PLOS ONE	Altered Topological Organization of White Matter Structural Networks in Patients with Neuromyelitis Optica
dong wenjia	China:Nanchang Univ, Dept Ophthalmol, Affiliated Hosp 1, Nanchang 330006, Jiangxi,Peoples R China. Nanchang University	INTERNATIONAL JOURNAL OF OPHTHALMOLOGY	Aerocyst urethral catheter insertion compared to expansion sponges application in external dacryocystorhinostomy
du yi	China:Sun Yat Sen Univ, State Key Lab Ophthalmol, Zhongshan Ophthalm Ctr, Guangzhou 510060, Guangdong,Peoples R China. Sun Yat Sen University	CANADIAN JOURNAL OF OPHTHALMOLOGY-JOURNAL CANADIEN D OPHTALMOLOGIE	Clinical features of 8 cases of orbital sparganosis in southern China
du yi	China:Sun Yat Sen Univ, State Key Lab Ophthalmol, Zhongshan Ophthalm Ctr, Guangzhou 510060, Guangdong,Peoples R China. Sun Yat Sen University	CURRENT EYE RESEARCH	Vision-Related Quality of Life Tends to be More Severely Impaired in Patients with Dysthyroid Optic Neuropathy
duan xuanchu	China:Cent S Univ, Dept Ophthalmol, Xiangya Hosp 2, Changsha 410011, Hunan,Peoples R China. Central South University	JOURNAL OF AAPOS	Primary synovial sarcoma in the orbit
duan yunyun	China:Capital Med Univ, Dept Radiol, Xuanwu Hosp, Beijing,Peoples R China. Capital Medical University	PLOS ONE	Altered Topological Organization of White Matter Structural Networks in Patients with Neuromyelitis Optica
fan fan	China:Chinese Univ Hong Kong, Hong Kong Eye Hosp, Dept Ophthalmol & Visual Sci, Kowloon, Hong Kong,Peoples R China. Chinese University of Hong Kong	JOURNAL OF PEDIATRIC OPHTHALMOLOGY & STRABISMUS	Anterior segment ischemia after two-muscle surgery in a patient with radiation-treated nasopharyngeal carcinoma
fan xianqun	China:Shanghai Jiao Tong Univ, Sch Med, Peoples Hosp 9, Dept Ophthalmol, Shanghai 200011,Peoples R China. Shanghai Jiao Tong University	EXPERIMENTAL EYE RESEARCH	Insulin-like growth factor 1 promotes the proliferation and adipogenesis of orbital adipose-derived stromal cells in thyroid-associated ophthalmopathy
fan xianqun	China:Shanghai Jiao Tong Univ, Sch Med, Peoples Hosp 9, Dept Ophthalmol, Shanghai 200011,Peoples R China. Shanghai Jiao Tong University	INVESTIGATIVE OPHTHALMOLOGY & VISUAL SCIENCE	In Vivo Efficacy of Bone Marrow Stromal Cells Coated with Beta-Tricalcium Phosphate for the Reconstruction of Orbital Defects in Canines
fan yongxiang	China:GuangZhou Med Univ, Key Lab Neurogenet & Channelopathies Guangdong Pr, Guangzhou, Guangdong,Peoples R China. Guangzhou Medical University	PLOS ONE	Serum Thyroid-Stimulating Hormone and Anti-Thyroglobulin Antibody Are Independently Associated with Lesions in Spinal Cord in Central Nervous System Demyelinating Diseases
fang zhijia	China:Sichuan Univ, Dept Radiol, West China Hosp, Chengdu 610041, Sichuan Provinc,Peoples R China. Sichuan University	INTERNATIONAL JOURNAL OF OPHTHALMOLOGY	CT features of exophthalmos in Chinese subjects with thyroid-associated ophthalmopathy
gao cong	China:GuangZhou Med Univ, Key Lab Neurogenet & Channelopathies Guangdong Pr, Guangzhou, Guangdong,Peoples R China. Guangzhou Medical University	PLOS ONE	Serum Thyroid-Stimulating Hormone and Anti-Thyroglobulin Antibody Are Independently Associated with Lesions in Spinal Cord in Central Nervous System Demyelinating Diseases
gao fei	China:Capital Med Univ, Beijing Tongren Hosp, Beijing Tongren Eye Ctr, Beijing Inst Ophthalmol, Beijing,Peoples R China. Capital Medical University	GRAEFES ARCHIVE FOR CLINICAL AND EXPERIMENTAL OPHTHALMOLOGY	Epithelial tumors of the lacrimal gland in the Chinese: a clinicopathologic study of 298 patients
gao guiping	China:Nanchang Univ, Dept Ophthalmol, Affiliated Hosp 1, Nanchang 330006, Jiangxi,Peoples R China. Nanchang University	INTERNATIONAL JOURNAL OF OPHTHALMOLOGY	Aerocyst urethral catheter insertion compared to expansion sponges application in external dacryocystorhinostomy
gao shaohui	China:Sun Yat Sen Univ, Zhongshan Ophthalm Ctr, State Key Lab Ophthalmol, Guangzhou 510060, Guangdong,Peoples R China. Sun Yat Sen University	GRAEFES ARCHIVE FOR CLINICAL AND EXPERIMENTAL OPHTHALMOLOGY	Metastatic orbital tumors in southern China during an 18-year period
gao xiaowei	China:Chinese PLA 474th Hosp, Dept Ophthalmol, Urumuchi 830013, Xinjiang Uygur,Peoples R China. 	INTERNATIONAL JOURNAL OF OPHTHALMOLOGY	Comparative study of modified and conventional secondary hydroxyapatite orbital implantations
gao xiaowei	China:Chinese PLA 474th Hosp, Dept Ophthalmol, Urumuchi 830013, Xinjiang Uygur,Peoples R China. 	INTERNATIONAL JOURNAL OF OPHTHALMOLOGY	Adhesion of cavernous hemangioma in the orbit revealed by CT and MRI: analysis of 97 cases
gao xing	China:Cent S Univ, Xiangya Hosp, Dept Oral & Maxillofacial Surg, Changsha 410008, Hunan,Peoples R China. Central South University	OPHTHALMIC PLASTIC AND RECONSTRUCTIVE SURGERY	Investigation of Anthropometric Measurements of Anatomic Structures of Orbital Soft Tissue in 102 Young Han Chinese Adults
gao yunxian	China:Xinjiang Med Univ TCM, Affiliated Hosp, Dept Ophthalmol, Urumuchi 830000, Xinjiang Uygur,Peoples R China. 	INTERNATIONAL JOURNAL OF OPHTHALMOLOGY	Comparative study of modified and conventional secondary hydroxyapatite orbital implantations
ge qin	China:Fudan Univ, Eye & ENT Hosp, Dept Ophthalmol, Shanghai 200031,Peoples R China. Fudan University	BRITISH JOURNAL OF OPHTHALMOLOGY	Treatment of orbital vascular malformations with intralesional injection of pingyangmycin
ge shengfang	China:Shanghai Jiao Tong Univ, Sch Med, Peoples Hosp 9, Dept Ophthalmol, Shanghai 200011,Peoples R China. Shanghai Jiao Tong University	INVESTIGATIVE OPHTHALMOLOGY & VISUAL SCIENCE	In Vivo Efficacy of Bone Marrow Stromal Cells Coated with Beta-Tricalcium Phosphate for the Reconstruction of Orbital Defects in Canines
geng yulei	China:Capital Med Univ, Beijing Tongren Eye Ctr, Beijing Tongren Hosp, Beijing Ophthalmol & Visual Sci Key Lab, Beijing 100730,Peoples R China. Capital Medical University	AMERICAN JOURNAL OF OPHTHALMOLOGY	Digital Evaluation of Orbital Development in Chinese Children With Congenital Microphthalmia
gu ping	China:Shanghai Jiao Tong Univ, Sch Med, Peoples Hosp 9, Dept Ophthalmol, Shanghai 200011,Peoples R China. Shanghai Jiao Tong University	EXPERIMENTAL EYE RESEARCH	Insulin-like growth factor 1 promotes the proliferation and adipogenesis of orbital adipose-derived stromal cells in thyroid-associated ophthalmopathy
gu zhaohui	China:Shanghai Jiao Tong Univ, Ruijin Hosp, Sch Med, State Key Lab Med Genom,Mol Med Ctr, Shanghai 200030,Peoples R China. Shanghai Jiao Tong University	PLOS ONE	A Refined Study of FCRL Genes from a Genome-Wide Association Study for Graves' Disease
gu zhaohui	China:Shanghai Jiao Tong Univ, Ruijin Hosp, Sch Med, State Key Lab Med Genom,Mol Med Ctr, Shanghai 200030,Peoples R China. Shanghai Jiao Tong University	PLOS ONE	Genetic Heterogeneity of Susceptibility Gene in Different Ethnic Populations: Refining Association Study of PTPN22 for Graves' Disease in a Chinese Han Population
guo hua	China:Shanghai Jiao Tong Univ, Sch Med, Dept Endocrinol & Metab, Ruijin Hosp,Shanghai Clin Ctr Endocrine & Metab D, Shanghai,Peoples R China. Shanghai Jiao Tong University	PLOS ONE	Chemokine (C-C Motif) Ligand 20, a Potential Biomarker for Graves' Disease, Is Regulated by Osteopontin
guo hui	China:Jilin Univ, Hosp 1, Dept Cent Lab, Changchun 130023,Peoples R China. Jilin University	PLOS ONE	A High Frequency of Circulating Th22 and Th17 Cells in Patients with New Onset Graves' Disease
guo jie	China:Fudan Univ, Dept Ophthalmol, Eye & ENT Hosp, Shanghai 200433,Peoples R China. Fudan University	CURRENT EYE RESEARCH	Histopathology and Immunohistochemical Profile in Idiopathic Dacryoadenitis
guo jie	China:Fudan Univ, Dept Ophthalmol, Eye & ENT Hosp, Shanghai 200433,Peoples R China. Fudan University	BRITISH JOURNAL OF OPHTHALMOLOGY	Treatment of orbital vascular malformations with intralesional injection of pingyangmycin
guo mingxia	China:Tianjin Med Univ, Sch Med Imaging, Tianjin 300203,Peoples R China. Tianjin Medical University	BRITISH JOURNAL OF OPHTHALMOLOGY	Grey and white matter changes in children with monocular amblyopia: voxel-based morphometry and diffusion tensor imaging study
han bing	China:Shanghai Jiao Tong Univ, Shanghai Peoples Hosp 9, Dept Endocrinol, Sch Med, Shanghai 200030,Peoples R China. Shanghai Jiao Tong University	PLOS ONE	Genetic Heterogeneity of Susceptibility Gene in Different Ethnic Populations: Refining Association Study of PTPN22 for Graves' Disease in a Chinese Han Population
han xueyao	China:Peking Univ, Peoples Hosp, Dept Endocrinol & Metab, Beijing 100871,Peoples R China. Peking University	PLOS ONE	Age at Diagnosis and C-Peptide Level Are Associated with Diabetic Retinopathy in Chinese
he jianfeng	China:Guangxi Med Univ, Affiliated Hosp 1, Dept Ophthalmol, Nanning, Guangxi,Peoples R China. Guangxi Medical University	CURRENT EYE RESEARCH	Vision-Related Quality of Life Tends to be More Severely Impaired in Patients with Dysthyroid Optic Neuropathy
he weimin	China:Sichuan Univ, Dept Ophthalmol, West China Hosp, Chengdu 610041, Sichuan Provinc,Peoples R China. Sichuan University	INTERNATIONAL JOURNAL OF OPHTHALMOLOGY	CT features of exophthalmos in Chinese subjects with thyroid-associated ophthalmopathy
he weimin	China:Sichuan Univ, Dept Ophthalmol, West China Hosp, Chengdu 610041, Sichuan Provinc,Peoples R China. Sichuan University	OPHTHALMOLOGICA	Clinical and Pathological Observation and Treatment of Chronic Orbital Osteomyelitis
he yong	China:Beijing Normal Univ, State Key Lab Cognit Neurosci & Learning, Beijing 100875,Peoples R China. Beijing Normal University	PLOS ONE	Altered Topological Organization of White Matter Structural Networks in Patients with Neuromyelitis Optica
he zhijing	China:Cent S Univ, Xiangya Hosp, Dept Oral & Maxillofacial Surg, Changsha 410008, Hunan,Peoples R China. Central South University	OPHTHALMIC PLASTIC AND RECONSTRUCTIVE SURGERY	Investigation of Anthropometric Measurements of Anatomic Structures of Orbital Soft Tissue in 102 Young Han Chinese Adults
hei yan	China:Armed Police Gen Hosp, Inst Orbital Dis, Beijing 100039,Peoples R China. 	CLINICAL AND EXPERIMENTAL OPHTHALMOLOGY	Heparanase-1 and components of the hedgehog signalling pathway are increased in untreated alveolar orbital rhabdomyosarcoma
ho wingl	China:Caritas Med Ctr, Dept Ophthalmol, Hong Kong, Hong Kong,Peoples R China. 	ACTA OPHTHALMOLOGICA	The ophthalmological complications of targeted agents in cancer therapy: what do we need to know as ophthalmologists?
hong jie	China:Shanghai Jiao Tong Univ, Sch Med, Dept Endocrinol & Metab, Ruijin Hosp,Shanghai Clin Ctr Endocrine & Metab D, Shanghai,Peoples R China. Shanghai Jiao Tong University	PLOS ONE	Chemokine (C-C Motif) Ligand 20, a Potential Biomarker for Graves' Disease, Is Regulated by Osteopontin
hou lijie	China:Wenzhou Med Coll, Hosp Eye, Wenzhou,Peoples R China. Wenzhou Medical University	INVESTIGATIVE OPHTHALMOLOGY & VISUAL SCIENCE	Measurement of the Limbus-Insertion Distance in Adult Strabismus Patients with Anterior Segment Optical Coherence Tomography
hou zhijia	China:Capital Med Univ, Beijing Tongren Hosp, Beijing Tongren Eye Ctr, Beijing 100730,Peoples R China. Capital Medical University	JOURNAL OF AAPOS	The use of self-inflating hydrogel expanders in pediatric patients with congenital microphthalmia in China
hu junmin	China:Wuhan Gen Hosp Guangzhou Command, Dept Neurosurg, PLA, Wuhan 430070,Peoples R China. 	INVESTIGATIVE OPHTHALMOLOGY & VISUAL SCIENCE	Enhancement of Axonal Regeneration of Retinal Ganglion Cells in Adult Rats by Etomidate: Involvement of Protein Kinase C
hu yamin	China:Shanghai Jiao Tong Univ, Sch Med, Peoples Hosp 9, Dept Ophthalmol, Shanghai 200011,Peoples R China. Shanghai Jiao Tong University	EXPERIMENTAL EYE RESEARCH	Insulin-like growth factor 1 promotes the proliferation and adipogenesis of orbital adipose-derived stromal cells in thyroid-associated ophthalmopathy
hu yiqian	China:Shanghai Jiao Tong Univ, Sch Med, Xinhua Hosp, Dept Ophthalmol, Shanghai 200092,Peoples R China. Shanghai Jiao Tong University	OPHTHALMOLOGY	Topical Anesthesia versus Regional Anesthesia for Cataract Surgery: A Meta-Analysis of Randomized Controlled Trials
huang danping	China:Sun Yat Sen Univ, Zhongshan Ophthal Ctr, Guangzhou 510060, Guangdong,Peoples R China. Sun Yat Sen University	AMERICAN JOURNAL OF OPHTHALMOLOGY	A Modified Evisceration Technique with Scleral Quadrisection and Porous Polyethylene Implantation
huang danping	China:Sun Yat Sen Univ, Zhongshan Ophthal Ctr, Guangzhou 510060, Guangdong,Peoples R China. Sun Yat Sen University	GRAEFES ARCHIVE FOR CLINICAL AND EXPERIMENTAL OPHTHALMOLOGY	Inflammatory cytokine profiles in the tears of thyroid-associated ophthalmopathy
huang fengjiao	China:Shanghai Jiao Tong Univ, Sch Med, Dept Endocrinol & Metab, Ruijin Hosp,Shanghai Clin Ctr Endocrine & Metab D, Shanghai,Peoples R China. Shanghai Jiao Tong University	PLOS ONE	Chemokine (C-C Motif) Ligand 20, a Potential Biomarker for Graves' Disease, Is Regulated by Osteopontin
huang jian	China:Guangxi Med Univ, Dept Clin Med, Nanning,Peoples R China. Guangxi Medical University	PLOS ONE	Association between the IL1B (-511), IL1B (+3954), IL1RN (VNTR) Polymorphisms and Graves' Disease Risk: A Meta-Analysis of 11 Case-Control Studies
huang juan	China:Sun Yat Sen Univ, Zhongshan Ophthalm Ctr, State Key Lab Ophthalmol, Guangzhou 510060, Guangdong,Peoples R China. Sun Yat Sen University	MOLECULAR VISION	Retro-orbital injection of FITC-dextran is an effective and economical method for observing mouse retinal vessels
huang liping	China:Chinese Peoples Liberat Army Gen Hosp, Dept Phys Therapy, Beijing 100853,Peoples R China. 	INTERNATIONAL JOURNAL OF OPHTHALMOLOGY	A technique for periorbital syringomas: intralesional radiofrequency ablation
huang shuo	China:Chinese Univ Hong Kong, Prince Wales Hosp, Sch Biomed Sci, Stem Cells & Regenerat Program, Shatin, Hong Kong,Peoples R China. Chinese University of Hong KongPrince of Wales Hospital	GRAEFES ARCHIVE FOR CLINICAL AND EXPERIMENTAL OPHTHALMOLOGY	Reconstruction of orbital defects by implantation of antigen-free bovine cancellous bone scaffold combined with bone marrow mesenchymal stem cells in rats
huang xuequan	China:Third Mil Med Univ, Southwest Hosp, Dept Radiol, Chongqing 400038,Peoples R China. Third Military Medical University	EUROPEAN JOURNAL OF OPHTHALMOLOGY	Adenoid cystic carcinoma of the lacrimal gland: CT and MRI findings
hung puikwan	China:Hong Kong Polytech Univ, Sch Optometry, Kowloon, Hong Kong,Peoples R China. Hong Kong Polytechnic University	OPHTHALMIC AND PHYSIOLOGICAL OPTICS	Intra-observer and inter-observer variation of Hertel exophthalmometry
ji linong	China:Peking Univ, Peoples Hosp, Dept Endocrinol & Metab, Beijing 100871,Peoples R China. Peking University	PLOS ONE	Age at Diagnosis and C-Peptide Level Are Associated with Diabetic Retinopathy in Chinese
jian xinchun	China:Cent S Univ, Xiangya Hosp, Dept Oral & Maxillofacial Surg, Changsha 410008, Hunan,Peoples R China. Central South University	OPHTHALMIC PLASTIC AND RECONSTRUCTIVE SURGERY	Investigation of Anthropometric Measurements of Anatomic Structures of Orbital Soft Tissue in 102 Young Han Chinese Adults
jiang bing	China:Cent S Univ, Xiangya Hosp 2, Dept Ophthalmol, Changsha 410083, Hunan,Peoples R China. Central South University	OCULAR IMMUNOLOGY AND INFLAMMATION	Granulomatosis with Polyangiitis: The Relationship Between Ocular and Nasal Disease
jiang fangzheng	China:Quzhou Peoples Hosp, Ophthalm Dept, Quzhou, Zhejiang,Peoples R China. 	AMERICAN JOURNAL OF OPHTHALMOLOGY	Endoscopic Transethmoidal Approach with or without Medial Rectus Detachment for Orbital Apical Cavernous Hemangiomas
jiang qinying	China:Tianjin Med Univ, Sch Med Imaging, Tianjin 300203,Peoples R China. Tianjin Medical University	BRITISH JOURNAL OF OPHTHALMOLOGY	Grey and white matter changes in children with monocular amblyopia: voxel-based morphometry and diffusion tensor imaging study
jiang tianyu	China:Chinese Peoples Liberat Army Gen Hosp, Dept Phys Therapy, Beijing 100853,Peoples R China. 	INTERNATIONAL JOURNAL OF OPHTHALMOLOGY	A technique for periorbital syringomas: intralesional radiofrequency ablation
jiang xiaohua	China:Shanghai Jiao Tong Univ, Sch Med, Dept Endocrinol & Metab, Ruijin Hosp,Shanghai Clin Ctr Endocrine & Metab D, Shanghai,Peoples R China. Shanghai Jiao Tong University	PLOS ONE	Chemokine (C-C Motif) Ligand 20, a Potential Biomarker for Graves' Disease, Is Regulated by Osteopontin
jiang yanfang	China:Jilin Univ, Key Lab Zoonosis Res, Minist Educ, Inst Zoonosis, Changchun 130023,Peoples R China. Jilin University	PLOS ONE	A High Frequency of Circulating Th22 and Th17 Cells in Patients with New Onset Graves' Disease
jiao yonghong	China:Capital Med Univ, Beijing Tongren Hosp, Beijing Tongren Eye Ctr, Beijing Ophthalmol & Visual Sci Key Lab, Beijing 100730,Peoples R China. Capital Medical University	JOURNAL OF AAPOS	Unilateral vertical retraction syndrome with orbital band
jiao yonghong	China:Capital Med Univ, Beijing Tongren Hosp, Beijing Tongren Eye Ctr, Beijing Ophthalmol & Visual Sci Key Lab, Beijing 100730,Peoples R China. Capital Medical University	JOURNAL OF AAPOS	Diagnosis and surgical treatment of unilateral restrictive hypotropia and esotropia
jie ying	China:Capital Med Univ, Beijing Tongren Hosp, Beijing Tongren Eye Ctr, Beijing Inst Ophthalmol, Beijing 100730,Peoples R China. Capital Medical University	OPHTHALMIC PLASTIC AND RECONSTRUCTIVE SURGERY	Reconstruction of anophthalmic orbits and contracted eye sockets with microvascular radial forearm free flaps
jin rui	China:Beijing Univ Technol, Coll Life Sci & Bioengn, Beijing,Peoples R China. Beijing University of Technology	PLOS ONE	Quantification of Epstein-Barr Virus DNA in Patients with Idiopathic Orbital Inflammatory Pseudotumor
jing wentao	China:Second Hosp Zhengzhou City, Zhengzhou City, Henan Province,Peoples R China. 	AMERICAN JOURNAL OF OPHTHALMOLOGY	Endoscopic Transethmoidal Approach with or without Medial Rectus Detachment for Orbital Apical Cavernous Hemangiomas
jing wentao	China:Second Hosp Zhengzhou City, Zhengzhou City, Henan Province,Peoples R China. 	OPHTHALMOLOGY	Endoscopic Transcaruncular Repair of Large Medial Orbital Wall Fractures Near the Orbital Apex
jonas jostb	China:Capital Med Univ, Beijing Tongren Hosp, Beijing Ophthalmol & Visual Sci Key Lab, Beijing Inst Ophthalmol,Beijing Tongren Eye Ctr, Beijing,Peoples R China. Capital Medical University	INVESTIGATIVE OPHTHALMOLOGY & VISUAL SCIENCE	Subfoveal Choroidal Thickness and Cerebrospinal Fluid Pressure: The Beijing Eye Study 2011
jonas jostb	China:Capital Med Univ, Beijing Tongren Hosp, Beijing Ophthalmol & Visual Sci Key Lab, Beijing Inst Ophthalmol,Beijing Tongren Eye Ctr, Beijing,Peoples R China. Capital Medical University	GRAEFES ARCHIVE FOR CLINICAL AND EXPERIMENTAL OPHTHALMOLOGY	Epithelial tumors of the lacrimal gland in the Chinese: a clinicopathologic study of 298 patients
kang li	China:Armed Police Gen Hosp, Inst Orbital Dis, Beijing 100039,Peoples R China. 	CLINICAL AND EXPERIMENTAL OPHTHALMOLOGY	Heparanase-1 and components of the hedgehog signalling pathway are increased in untreated alveolar orbital rhabdomyosarcoma
kang li	China:Armed Police Gen Hosp, Inst Orbital Dis, Beijing 100039,Peoples R China. 	JAPANESE JOURNAL OF OPHTHALMOLOGY	Infrequent bilateral orbital tumors and simulating lesions: The experience of a Chinese institute
lam lam	China:Hong Kong Polytech Univ, Sch Optometry, Kowloon, Hong Kong,Peoples R China. Hong Kong Polytechnic University	OPHTHALMIC AND PHYSIOLOGICAL OPTICS	Intra-observer and inter-observer variation of Hertel exophthalmometry
lam lam	China:Hong Kong Polytech Univ, Sch Optometry, Kowloon, Hong Kong,Peoples R China. Hong Kong Polytechnic University	EUROPEAN JOURNAL OF OPHTHALMOLOGY	Late leakage of filtering bleb in a patient with orbital pseudotumor
lam lam	China:Hong Kong Polytech Univ, Sch Optometry, Kowloon, Hong Kong,Peoples R China. Hong Kong Polytechnic University	OPHTHALMIC PLASTIC AND RECONSTRUCTIVE SURGERY	Surgical anatomy of the Chinese orbit
lam lam	China:Hong Kong Polytech Univ, Sch Optometry, Kowloon, Hong Kong,Peoples R China. Hong Kong Polytechnic University	JOURNAL OF PEDIATRIC OPHTHALMOLOGY & STRABISMUS	Anterior segment ischemia after two-muscle surgery in a patient with radiation-treated nasopharyngeal carcinoma
lam chunfai	China:Hong Kong Polytech Univ, Sch Optometry, Kowloon, Hong Kong,Peoples R China. Hong Kong Polytechnic University	OPHTHALMIC AND PHYSIOLOGICAL OPTICS	Intra-observer and inter-observer variation of Hertel exophthalmometry
law kwaimei	China:Hong Kong Polytech Univ, Sch Optometry, Hong Kong, Hong Kong,Peoples R China. Hong Kong Polytechnic University	CLINICAL AND EXPERIMENTAL OPTOMETRY	Thyroid disease induced diplopia
lee allie	China:Chinese Univ Hong Kong, Dept Ophthalmol & Visual Sci, Hong Kong, Hong Kong,Peoples R China. Chinese University of Hong Kong	OPHTHALMIC PLASTIC AND RECONSTRUCTIVE SURGERY	Inferonasal Prolapsed Orbital Fat: Report of a Case and Review of Literature
lei bo	China:Chongqing Med Univ, Dept Ophthalmol, Affiliated Hosp 1, Chongqing Key Lab Ophthalmol,Chongqing Eye Inst, Chongqing 400016,Peoples R China. Chongqing Medical University	CURRENT EYE RESEARCH	Effects of Three Commonly Used Anesthetics on Intraocular Pressure in Mouse
leung leung	China:Chinese Univ Hong Kong, Dept Ophthalmol & Visual Sci, Hong Kong Eye Hosp, Kowloon, Hong Kong,Peoples R China. Chinese University of Hong Kong	EUROPEAN JOURNAL OF OPHTHALMOLOGY	Late leakage of filtering bleb in a patient with orbital pseudotumor
leung waikit	China:Hong Kong Polytech Univ, Sch Optometry, Kowloon, Hong Kong,Peoples R China. Hong Kong Polytechnic University	OPHTHALMIC AND PHYSIOLOGICAL OPTICS	Intra-observer and inter-observer variation of Hertel exophthalmometry
li bin	China:Capital Med Univ, Beijing Tongren Hosp, Beijing Tongren Eye Ctr, Beijing Inst Ophthalmol, Beijing,Peoples R China. Capital Medical University	GRAEFES ARCHIVE FOR CLINICAL AND EXPERIMENTAL OPHTHALMOLOGY	Epithelial tumors of the lacrimal gland in the Chinese: a clinicopathologic study of 298 patients
li bin	China:Capital Med Univ, Beijing Tongren Hosp, Beijing Tongren Eye Ctr, Beijing Inst Ophthalmol, Beijing,Peoples R China. Capital Medical University	ACTA OPHTHALMOLOGICA	Cerebrospinal fluid pressure in ocular hypertension
li dongmei	China:Capital Med Univ, Beijing Tongren Eye Ctr, Beijing Tongren Hosp, Beijing Ophthalmol & Visual Sci Key Lab, Beijing 100730,Peoples R China. Capital Medical University	AMERICAN JOURNAL OF OPHTHALMOLOGY	Digital Evaluation of Orbital Development in Chinese Children With Congenital Microphthalmia
li dongmei	China:Capital Med Univ, Beijing Tongren Eye Ctr, Beijing Tongren Hosp, Beijing Ophthalmol & Visual Sci Key Lab, Beijing 100730,Peoples R China. Capital Medical University	OPHTHALMIC PLASTIC AND RECONSTRUCTIVE SURGERY	Reconstruction of anophthalmic orbits and contracted eye sockets with microvascular radial forearm free flaps
li emmyy	China:Chinese Univ Hong Kong, Dept Ophthalmol & Visual Sci, Hong Kong, Hong Kong,Peoples R China. Chinese University of Hong Kong	OPHTHALMIC PLASTIC AND RECONSTRUCTIVE SURGERY	Inferonasal Prolapsed Orbital Fat: Report of a Case and Review of Literature
li gang	China:Chinese Univ Hong Kong, Prince Wales Hosp, Sch Biomed Sci, Stem Cells & Regenerat Program, Shatin, Hong Kong,Peoples R China. Chinese University of Hong KongPrince of Wales Hospital	GRAEFES ARCHIVE FOR CLINICAL AND EXPERIMENTAL OPHTHALMOLOGY	Reconstruction of orbital defects by implantation of antigen-free bovine cancellous bone scaffold combined with bone marrow mesenchymal stem cells in rats
li guigang	China:Huazhong Univ Sci & Technol, Tongji Med Coll, Tongji Hosp, Dept Ophthalmol, Wuhan 430074,Peoples R China. Huazhong University of Science & Technology	OPHTHALMIC PLASTIC AND RECONSTRUCTIVE SURGERY	The Psychosocial Benefits of Secondary Hydroxyapatite Orbital Implant Insertion and Prosthesis Wearing for Patients With Anophthalmia
li hongni	China:Shantou Cent Hosp, Dept Ophthalmol, Shantou, Guangdong,Peoples R China. 	PLOS ONE	Epidemiology of Pediatric Ocular Trauma in the Chaoshan Region, China, 2001-2010
li hui	China:Chinese Acad Med Sci, Peking Union Med Coll Hosp, Dept Ophthalmol, Beijing 100730,Peoples R China. Chinese Academy of Medical Sciences - Peking Union Medical College	GRAEFES ARCHIVE FOR CLINICAL AND EXPERIMENTAL OPHTHALMOLOGY	Locally produced insulin-like growth factor-1 by orbital fibroblasts as implicative pathogenic factor rather than systemically circulated IGF-1 for patients with thyroid-associated ophthalmopathy
li kaijun	China:Guangxi Med Univ, Affiliated Hosp 1, Dept Ophthalmol, Nanning, Guangxi,Peoples R China. Guangxi Medical University	CURRENT EYE RESEARCH	Vision-Related Quality of Life Tends to be More Severely Impaired in Patients with Dysthyroid Optic Neuropathy
li kuncheng	China:Capital Med Univ, Dept Radiol, Xuanwu Hosp, Beijing,Peoples R China. Capital Medical University	PLOS ONE	Altered Topological Organization of White Matter Structural Networks in Patients with Neuromyelitis Optica
li liaoqing	China:Capital Med Univ, Beijing Tongren Hosp, Beijing Tongren Eye Ctr, Beijing Inst Ophthalmol, Beijing,Peoples R China. Capital Medical University	GRAEFES ARCHIVE FOR CLINICAL AND EXPERIMENTAL OPHTHALMOLOGY	Epithelial tumors of the lacrimal gland in the Chinese: a clinicopathologic study of 298 patients
li liming	China:Shanghai Jiao Tong Univ, Dept Biomed Engn, Inst Laser Med & Biophoton, Shanghai 200240,Peoples R China. Shanghai Jiao Tong University	GRAEFES ARCHIVE FOR CLINICAL AND EXPERIMENTAL OPHTHALMOLOGY	Intraorbital optic nerve stimulation with penetrating electrodes: in vivo electrophysiology study in rabbits
li liming	China:Shanghai Jiao Tong Univ, Dept Biomed Engn, Inst Laser Med & Biophoton, Shanghai 200240,Peoples R China. Shanghai Jiao Tong University	INVESTIGATIVE OPHTHALMOLOGY & VISUAL SCIENCE	Spatiotemporal Properties of Multipeaked Electrically Evoked Potentials Elicited by Penetrative Optic Nerve Stimulation in Rabbits
li liping	China:Shantou Univ, Coll Med, Injury Prevent Res Ctr, Shantou, Guangdong,Peoples R China. Shantou University	PLOS ONE	Epidemiology of Pediatric Ocular Trauma in the Chaoshan Region, China, 2001-2010
li qian	China:Tianjin Med Univ, Dept Radiol, Canc Inst & Hosp, Key Lab Canc Prevent & Therapy, Tianjin 300203,Peoples R China. Tianjin Medical University	BRITISH JOURNAL OF OPHTHALMOLOGY	Grey and white matter changes in children with monocular amblyopia: voxel-based morphometry and diffusion tensor imaging study
li qingji	China:Tianjin Med Univ, Dept Ocular Plast Surg, Clin Coll Ophthalmol, Tianjin 300203,Peoples R China. Tianjin Medical University	BRITISH JOURNAL OF OPHTHALMOLOGY	Grey and white matter changes in children with monocular amblyopia: voxel-based morphometry and diffusion tensor imaging study
li shiqing	China:Sun Yat Sen Univ, Zhongshan Ophthalm Ctr, State Key Lab Ophthalmol, Guangzhou 510060, Guangdong,Peoples R China. Sun Yat Sen University	MOLECULAR VISION	Retro-orbital injection of FITC-dextran is an effective and economical method for observing mouse retinal vessels
li tao	China:Sun Yat Sen Univ, Zhongshan Ophthalm Ctr, State Key Lab Ophthalmol, Guangzhou 510060, Guangdong,Peoples R China. Sun Yat Sen University	MOLECULAR VISION	Retro-orbital injection of FITC-dextran is an effective and economical method for observing mouse retinal vessels
li weiye	China:Chinese Acad Med Sci, Peking Union Med Coll Hosp, Dept Ophthalmol, Beijing 100730,Peoples R China. Chinese Academy of Medical Sciences - Peking Union Medical College	GRAEFES ARCHIVE FOR CLINICAL AND EXPERIMENTAL OPHTHALMOLOGY	Locally produced insulin-like growth factor-1 by orbital fibroblasts as implicative pathogenic factor rather than systemically circulated IGF-1 for patients with thyroid-associated ophthalmopathy
li xiaoli	China:Chinese Acad Sci, Shanghai Inst Biol Sci, Inst Hlth Sci, Lab Endocrinol & Metab, Shanghai,Peoples R China. Chinese Academy of SciencesShanghai Institutes for Biological Sciences	PLOS ONE	Chemokine (C-C Motif) Ligand 20, a Potential Biomarker for Graves' Disease, Is Regulated by Osteopontin
li xiaoliang	China:Shanghai Jiao Tong Univ, Dept Biomed Engn, Sch Life Sci & Biotechnol, Shanghai 200240,Peoples R China. Shanghai Jiao Tong University	INVESTIGATIVE OPHTHALMOLOGY & VISUAL SCIENCE	Spatiotemporal Properties of Multipeaked Electrically Evoked Potentials Elicited by Penetrative Optic Nerve Stimulation in Rabbits
li xiaorong	China:Tianjin Med Univ, Hosp Eye, Coll Optometry, Inst Eye, Tianjin 300384,Peoples R China. Tianjin Medical University	GRAEFES ARCHIVE FOR CLINICAL AND EXPERIMENTAL OPHTHALMOLOGY	Reconstruction of orbital defects by implantation of antigen-free bovine cancellous bone scaffold combined with bone marrow mesenchymal stem cells in rats
li xiaoxin	China:Beijing Univ, Dept Ophthalmol, Affiliated Beijing Peoples Hosp, Beijing 100044,Peoples R China. Peking University	GRAEFES ARCHIVE FOR CLINICAL AND EXPERIMENTAL OPHTHALMOLOGY	Intraorbital optic nerve stimulation with penetrating electrodes: in vivo electrophysiology study in rabbits
li yan	China:Cent S Univ, Xiangya Hosp, Dept Oral & Maxillofacial Surg, Changsha 410008, Hunan,Peoples R China. Central South University	OPHTHALMIC PLASTIC AND RECONSTRUCTIVE SURGERY	Investigation of Anthropometric Measurements of Anatomic Structures of Orbital Soft Tissue in 102 Young Han Chinese Adults
li yiming	China:Fudan Univ, Dept Endocrinol & Metab, Huashan Hosp, Shanghai 200433,Peoples R China. Fudan University	PLOS ONE	Decrease in Proportion of CD19(+)CD24(hi)CD27(+) B Cells and Impairment of Their Suppressive Function in Graves' Disease
li yong	China:Capital Med Univ, Beijing Tongren Hosp, Dept Radiol, Beijing,Peoples R China. Capital Medical University	OPHTHALMOLOGY	Orbital Cerebrospinal Fluid Space in Glaucoma Reply
li yong	China:Capital Med Univ, Beijing Tongren Hosp, Dept Radiol, Beijing,Peoples R China. Capital Medical University	OPHTHALMOLOGY	Orbital Cerebrospinal Fluid Space in Glaucoma: The Beijing Intracranial and Intraocular Pressure (iCOP) Study
li yongping	China:Sun Yat Sen Univ, Dept Pathol, Guangzhou 510060, Guangdong,Peoples R China. Sun Yat Sen University	JOURNAL OF PEDIATRIC OPHTHALMOLOGY & STRABISMUS	Rhabdomyoma of the orbit
li you	China:Second Mil Med Univ, Shanghai Changzheng Hosp, Dept Ophthalmol, Shanghai 200003,Peoples R China. Second Military Medical University	INVESTIGATIVE OPHTHALMOLOGY & VISUAL SCIENCE	The Expression of Intercellular Adhesion Molecule-1 Induced by CD40-CD40L Ligand Signaling in Orbital Fibroblasts in Patients with Graves' Ophthalmopathy
li yueyue	China:Gen Hosp Armed Police Forces, Inst Orbital Dis, Beijing,Peoples R China. 	JOURNAL OF AAPOS	Orbital dermoid cyst with sinus tract mimicking ectopic cilia
li yumei	China:Zhejiang Prov Peoples Hosp, Dept Radiol, Hangzhou, Zhejiang,Peoples R China. 	PLOS ONE	Idiopathic Orbital Inflammation Syndrome with Retro-Orbital Involvement: A Retrospective Study of Eight Patients
liang jun	China:Xuzhou Med Coll, Cent Hosp Xuzhou, Dept Endocrinol, Xuzhou, Jiangsu,Peoples R China. Xuzhou Medical College	PLOS ONE	Genetic Heterogeneity of Susceptibility Gene in Different Ethnic Populations: Refining Association Study of PTPN22 for Graves' Disease in a Chinese Han Population
liang xiaoling	China:Sun Yat Sen Univ, State Key Lab Ophthalmol, Zhongshan Ophthalm Ctr, Guangzhou 510060, Guangdong,Peoples R China. Sun Yat Sen University	ARCHIVES OF OPHTHALMOLOGY	Novel SOX2 mutation associated with ocular coloboma in a Chinese family
liang xiaoling	China:Sun Yat Sen Univ, State Key Lab Ophthalmol, Zhongshan Ophthalm Ctr, Guangzhou 510060, Guangdong,Peoples R China. Sun Yat Sen University	MOLECULAR VISION	Retro-orbital injection of FITC-dextran is an effective and economical method for observing mouse retinal vessels
liao ning	China:Guangxi Med Univ, Dept Geriatr & Gerontol, Affiliated Hosp 1, Nanning,Peoples R China. Guangxi Medical University	PLOS ONE	Association between the IL1B (-511), IL1B (+3954), IL1RN (VNTR) Polymorphisms and Graves' Disease Risk: A Meta-Analysis of 11 Case-Control Studies
lin biweng	China:Chinese Peoples Liberat Army Gen Hosp, Dept Dermatol, Beijing 100853,Peoples R China. 	INTERNATIONAL JOURNAL OF OPHTHALMOLOGY	A technique for periorbital syringomas: intralesional radiofrequency ablation
lin dongping	China:Shanghai Jiao Tong Univ, Dept Endocrinol & Metab, Peoples Hosp 9, Shanghai 200030,Peoples R China. Shanghai Jiao Tong University	PLOS ONE	Chemokine (C-C Motif) Ligand 20, a Potential Biomarker for Graves' Disease, Is Regulated by Osteopontin
lin qi	China:Capital Med Univ, Beijing Childrens Hosp, Beijing,Peoples R China. Capital Medical University	JOURNAL OF AAPOS	Diagnosis and surgical treatment of unilateral restrictive hypotropia and esotropia
ling zhihong	China:Shanghai Med Coll, Eye & ENT Hosp, Dept Ophthalmol & Vis Sci, Shanghai,Peoples R China. 	JOURNAL OF GLAUCOMA	Parapapillary Gamma Zone Hole
liu baoan	China:Cent S Univ, Dept Ophthalmol, Xiangya Hosp 2, Changsha 410011, Hunan,Peoples R China. Central South University	JOURNAL OF AAPOS	Primary synovial sarcoma in the orbit
liu bingli	China:Shanghai Jiao Tong Univ, Ruijin Hosp, Sch Med, State Key Lab Med Genom,Mol Med Ctr, Shanghai 200030,Peoples R China. Shanghai Jiao Tong University	PLOS ONE	A Refined Study of FCRL Genes from a Genome-Wide Association Study for Graves' Disease
liu dong	China:Tianjin Med Univ, Hosp 2, Gamma Knife Ctr, Dept Neurosurg, Tianjin 300211,Peoples R China. Tianjin Medical University	BRITISH JOURNAL OF OPHTHALMOLOGY	Gamma knife radiosurgery for primary orbital varices: a preliminary report
liu guoying	China:Peoples Hosp Nanhai Dist, Dept Ophthalmol, Foshan,Peoples R China. 	CANADIAN JOURNAL OF OPHTHALMOLOGY-JOURNAL CANADIEN D OPHTALMOLOGIE	Clinical features of 8 cases of orbital sparganosis in southern China
liu jiagang	China:Sichuan Univ, Dept Neurosurg, W China Hosp, Chengdu 610041, Sichuan Provinc,Peoples R China. Sichuan University	MOLECULAR VISION	Retinal whole genome microarray analysis and early morphological changes in the optic nerves of monkeys after an intraorbital nerve irradiated injury
liu jingming	China:Capital Med Univ, Dept Stomatol, Tongren Hosp, Beijing,Peoples R China. Capital Medical University	OPHTHALMIC PLASTIC AND RECONSTRUCTIVE SURGERY	Reconstruction of anophthalmic orbits and contracted eye sockets with microvascular radial forearm free flaps
liu jun	China:Fudan Univ, Dept Endocrinol & Metab, Shanghai Peoples Hosp 5, Shanghai 200433,Peoples R China. Fudan University	PLOS ONE	Decrease in Proportion of CD19(+)CD24(hi)CD27(+) B Cells and Impairment of Their Suppressive Function in Graves' Disease
liu ke	China:Cent S Univ, Dept Ophthalmol, Xiangya Hosp 2, Changsha 410011, Hunan,Peoples R China. Central South University	JOURNAL OF AAPOS	Primary synovial sarcoma in the orbit
liu mingming	China:Third Mil Med Univ, Oculoplast & Orbital Div, SW Eye Hosp SW Hosp, Chongqing 400038,Peoples R China. Third Military Medical University	OPHTHALMIC PLASTIC AND RECONSTRUCTIVE SURGERY	Lime Burns Resulting in Total Conjunctival Defect, Enucleation, and Fused Eyelids
liu mingming	China:Third Mil Med Univ, Oculoplast & Orbital Div, SW Eye Hosp SW Hosp, Chongqing 400038,Peoples R China. Third Military Medical University	EUROPEAN JOURNAL OF OPHTHALMOLOGY	Adenoid cystic carcinoma of the lacrimal gland: CT and MRI findings
liu wei	China:Shanghai Jiao Tong Univ, Ruijin Hosp, Sch Med, State Key Lab Med Genom,Mol Med Ctr, Shanghai 200030,Peoples R China. Shanghai Jiao Tong University	PLOS ONE	A Refined Study of FCRL Genes from a Genome-Wide Association Study for Graves' Disease
liu wei	China:Shanghai Jiao Tong Univ, Ruijin Hosp, Sch Med, State Key Lab Med Genom,Mol Med Ctr, Shanghai 200030,Peoples R China. Shanghai Jiao Tong University	PLOS ONE	Genetic Heterogeneity of Susceptibility Gene in Different Ethnic Populations: Refining Association Study of PTPN22 for Graves' Disease in a Chinese Han Population
liu xiaocui	China:Chinese Peoples Liberat Army Gen Hosp, Dept Ophthalmol, Beijing 100853,Peoples R China. 	INTERNATIONAL JOURNAL OF OPHTHALMOLOGY	A technique for periorbital syringomas: intralesional radiofrequency ablation
liu xiaoming	China:Fudan Univ, Biotherapy Res Ctr, Shanghai Med Coll, Shanghai 200433,Peoples R China. Fudan University	PLOS ONE	Decrease in Proportion of CD19(+)CD24(hi)CD27(+) B Cells and Impairment of Their Suppressive Function in Graves' Disease
liu xiaoqiang	China:Tongji Univ, Sch Med, Dept Ophthalmol, Shanghai Peoples Hosp 10, Shanghai 200072,Peoples R China. Tongji University	INVESTIGATIVE OPHTHALMOLOGY & VISUAL SCIENCE	Measurement of the Limbus-Insertion Distance in Adult Strabismus Patients with Anterior Segment Optical Coherence Tomography
liu xuesong	China:Sichuan Univ, Dept Neurosurg, W China Hosp, Chengdu 610041, Sichuan Provinc,Peoples R China. Sichuan University	MOLECULAR VISION	Retinal whole genome microarray analysis and early morphological changes in the optic nerves of monkeys after an intraorbital nerve irradiated injury
liu xuyang	China:Sichuan Univ, Dept Ophthalmol, W China Hosp, Chengdu 610041, Sichuan Provinc,Peoples R China. Sichuan University	MOLECULAR VISION	Retinal whole genome microarray analysis and early morphological changes in the optic nerves of monkeys after an intraorbital nerve irradiated injury
liu yan	China:Cent S Univ, Xiangya Hosp, Dept Ophthalmol, Changsha 410008, Hunan,Peoples R China. Central South University	INTERNATIONAL JOURNAL OF OPHTHALMOLOGY	Transcranial surgery through pterional approach for removal of cranio -orbital tumors by an interdisciplinary team of nurosurgeons and ophthalmologists
liu yaou	China:Capital Med Univ, Dept Radiol, Xuanwu Hosp, Beijing,Peoples R China. Capital Medical University	PLOS ONE	Altered Topological Organization of White Matter Structural Networks in Patients with Neuromyelitis Optica
long youming	China:GuangZhou Med Univ, Key Lab Neurogenet & Channelopathies Guangdong Pr, Guangzhou, Guangdong,Peoples R China. Guangzhou Medical University	PLOS ONE	Serum Thyroid-Stimulating Hormone and Anti-Thyroglobulin Antibody Are Independently Associated with Lesions in Spinal Cord in Central Nervous System Demyelinating Diseases
lu rong	China:Sun Yat Sen Univ, Zhongshan Ophthal Ctr, Guangzhou 510060, Guangdong,Peoples R China. Sun Yat Sen University	AMERICAN JOURNAL OF OPHTHALMOLOGY	A Modified Evisceration Technique with Scleral Quadrisection and Porous Polyethylene Implantation
lu yiliang	China:Shanghai Jiao Tong Univ, Dept Biomed Engn, Sch Life Sci & Biotechnol, Shanghai 200240,Peoples R China. Shanghai Jiao Tong University	INVESTIGATIVE OPHTHALMOLOGY & VISUAL SCIENCE	Spatiotemporal Properties of Multipeaked Electrically Evoked Potentials Elicited by Penetrative Optic Nerve Stimulation in Rabbits
lucas peterw	China:Univ Hong Kong, Li Ka Shing Fac Med, Dept Anat, Pokfulam, Hong Kong,Peoples R China. University of Hong Kong	OPHTHALMIC PLASTIC AND RECONSTRUCTIVE SURGERY	Surgical anatomy of the Chinese orbit
luk luk	China:Chinese Univ Hong Kong, Dept Ophthalmol & Visual Sci, Hong Kong Eye Hosp, Kowloon, Hong Kong,Peoples R China. Chinese University of Hong Kong	EUROPEAN JOURNAL OF OPHTHALMOLOGY	Late leakage of filtering bleb in a patient with orbital pseudotumor
luo qingli	China:Sichuan Univ, W China Hosp, Dept Ophthalmol, Chengdu 610041,Peoples R China. Sichuan University	OPHTHALMOLOGICA	Clinical and Pathological Observation and Treatment of Chronic Orbital Osteomyelitis
luo xin	China:Sun Yat Sen Univ, State Key Lab Ophthalmol, Zhongshan Ophthalm Ctr, Guangzhou 510060, Guangdong,Peoples R China. Sun Yat Sen University	CANADIAN JOURNAL OF OPHTHALMOLOGY-JOURNAL CANADIEN D OPHTALMOLOGIE	Clinical features of 8 cases of orbital sparganosis in southern China
luo yan	China:Sun Yat Sen Univ, Zhongshan Ophthalm Ctr, State Key Lab Ophthalmol, Guangzhou 510060, Guangdong,Peoples R China. Sun Yat Sen University	MOLECULAR VISION	Retro-orbital injection of FITC-dextran is an effective and economical method for observing mouse retinal vessels
luo yingying	China:Peking Univ, Peoples Hosp, Dept Endocrinol & Metab, Beijing 100871,Peoples R China. Peking University	PLOS ONE	Age at Diagnosis and C-Peptide Level Are Associated with Diabetic Retinopathy in Chinese
ma jiangrong	China:Cent S Univ, Xiangya Hosp, Dept Neurosurg, Changsha 410008, Hunan,Peoples R China. Central South University	INTERNATIONAL JOURNAL OF OPHTHALMOLOGY	Transcranial surgery through pterional approach for removal of cranio -orbital tumors by an interdisciplinary team of nurosurgeons and ophthalmologists
ma jianmin	China:Capital Med Univ, Beijing Tongren Hosp, Beijing Tongren Eye Ctr, Beijing Ophthalmol & Vis Sci Key Lab, Beijing,Peoples R China. Capital Medical University	PLOS ONE	Quantification of Epstein-Barr Virus DNA in Patients with Idiopathic Orbital Inflammatory Pseudotumor
ma jianmin	China:Capital Med Univ, Beijing Tongren Hosp, Beijing Tongren Eye Ctr, Beijing Ophthalmol & Vis Sci Key Lab, Beijing,Peoples R China. Capital Medical University	INTERNATIONAL JOURNAL OF OPHTHALMOLOGY	Dedifferentiated orbital liposarcoma: a case report
ma jianrong	China:Cent S Univ, Xiangya Hosp, Dept Neurol, Changsha 410008, Hunan,Peoples R China. Central South University	INTERNATIONAL JOURNAL OF OPHTHALMOLOGY	Reconstruction of complex orbital fracture with titanium implants
ma lianting	China:Wuhan Gen Hosp Guangzhou Command, Dept Neurosurg, PLA, Wuhan 430070,Peoples R China. 	INVESTIGATIVE OPHTHALMOLOGY & VISUAL SCIENCE	Enhancement of Axonal Regeneration of Retinal Ganglion Cells in Adult Rats by Etomidate: Involvement of Protein Kinase C
ma lu	China:Sichuan Univ, Dept Neurosurg, W China Hosp, Chengdu 610041, Sichuan Provinc,Peoples R China. Sichuan University	MOLECULAR VISION	Retinal whole genome microarray analysis and early morphological changes in the optic nerves of monkeys after an intraorbital nerve irradiated injury
ma xiaoping	China:Fudan Univ, ZhongShan Hosp, Sch Med, Dept Ophthalmol, Shanghai 200433,Peoples R China. Fudan University	OPHTHALMIC PLASTIC AND RECONSTRUCTIVE SURGERY	The Porous Polyethylene/Bioglass Spherical Orbital Implant: A Retrospective Study of 170 Cases
ma xinran	China:Chinese Acad Sci, Shanghai Inst Biol Sci, Inst Hlth Sci, Lab Endocrinol & Metab, Shanghai,Peoples R China. Chinese Academy of SciencesShanghai Institutes for Biological Sciences	PLOS ONE	Chemokine (C-C Motif) Ligand 20, a Potential Biomarker for Graves' Disease, Is Regulated by Osteopontin
ma xuemei	China:Beijing Univ Technol, Coll Life Sci & Bioengn, Beijing,Peoples R China. Beijing University of Technology	PLOS ONE	Quantification of Epstein-Barr Virus DNA in Patients with Idiopathic Orbital Inflammatory Pseudotumor
man fengyuan	China:Capital Med Univ, Beijing Tongren Hosp, Beijing Tongren Med Imaging Ctr, Beijing,Peoples R China. Capital Medical University	JOURNAL OF AAPOS	Diagnosis and surgical treatment of unilateral restrictive hypotropia and esotropia
man fengyuan	China:Capital Med Univ, Beijing Tongren Hosp, Beijing Tongren Med Imaging Ctr, Beijing,Peoples R China. Capital Medical University	JOURNAL OF AAPOS	Unilateral vertical retraction syndrome with orbital band
mao chi	China:Capital Med Univ, Dept Stomatol, Tongren Hosp, Beijing,Peoples R China. Capital Medical University	OPHTHALMIC PLASTIC AND RECONSTRUCTIVE SURGERY	Reconstruction of anophthalmic orbits and contracted eye sockets with microvascular radial forearm free flaps
ng dannysiuchun	China:Tung Wah Eastern Hosp, Dept Ophthalmol, Hong Kong, Hong Kong,Peoples R China. 	INTERNATIONAL JOURNAL OF OPHTHALMOLOGY	Clinicopathological survey of 23 patients with lacrimal fossa lesions in Hong Kong
nie li	China:Wenzhou Med Coll, Eye Hosp Ophthalmol & Optometry, Wenzhou,Peoples R China. Wenzhou Medical University	JOURNAL OF PEDIATRIC OPHTHALMOLOGY & STRABISMUS	Rhabdomyoma of the orbit
ning guang	China:Chinese Acad Sci, Shanghai Inst Biol Sci, Inst Hlth Sci, Lab Endocrinol & Metab, Shanghai,Peoples R China. Chinese Academy of SciencesShanghai Institutes for Biological Sciences	PLOS ONE	Chemokine (C-C Motif) Ligand 20, a Potential Biomarker for Graves' Disease, Is Regulated by Osteopontin
ou xinrong	China:Cent S Univ, Xiangya Hosp, Dept Oral & Maxillofacial, Changsha 410008, Hunan,Peoples R China. Central South University	INTERNATIONAL JOURNAL OF OPHTHALMOLOGY	Reconstruction of complex orbital fracture with titanium implants
pan borong	China:Fourth Mil Med Univ, Xijing Hosp, Tumor Ctr, Xian 710000, Shaanxi Provinc,Peoples R China. Fourth Military Medical University	INTERNATIONAL JOURNAL OF OPHTHALMOLOGY	Data analysis of low dose multislice helical CT scan in orbital trauma
pan chunming	China:Shanghai Jiao Tong Univ, Ruijin Hosp, Sch Med, State Key Lab Med Genom,Mol Med Ctr, Shanghai 200030,Peoples R China. Shanghai Jiao Tong University	PLOS ONE	A Refined Study of FCRL Genes from a Genome-Wide Association Study for Graves' Disease
pan chunming	China:Shanghai Jiao Tong Univ, Ruijin Hosp, Sch Med, State Key Lab Med Genom,Mol Med Ctr, Shanghai 200030,Peoples R China. Shanghai Jiao Tong University	PLOS ONE	Genetic Heterogeneity of Susceptibility Gene in Different Ethnic Populations: Refining Association Study of PTPN22 for Graves' Disease in a Chinese Han Population
pei chonggang	China:Nanchang Univ, Dept Ophthalmol, Affiliated Hosp 1, Nanchang 330006, Jiangxi,Peoples R China. Nanchang University	INTERNATIONAL JOURNAL OF OPHTHALMOLOGY	Aerocyst urethral catheter insertion compared to expansion sponges application in external dacryocystorhinostomy
peng di	China:Jilin Univ, Hosp 1, Dept Cent Lab, Changchun 130023,Peoples R China. Jilin University	PLOS ONE	A High Frequency of Circulating Th22 and Th17 Cells in Patients with New Onset Graves' Disease
peng xiaoxia	China:Capital Med Univ, Dept Stat, Beijing 100730,Peoples R China. Capital Medical University	OPHTHALMOLOGY	Orbital Cerebrospinal Fluid Space in Glaucoma: The Beijing Intracranial and Intraocular Pressure (iCOP) Study
peng xiaoxia	China:Capital Med Univ, Dept Stat, Beijing 100730,Peoples R China. Capital Medical University	OPHTHALMOLOGY	Orbital Cerebrospinal Fluid Space in Glaucoma Reply
qi yicheng	China:Chinese Acad Sci, Shanghai Inst Biol Sci, Inst Hlth Sci, Lab Endocrinol & Metab, Shanghai,Peoples R China. Chinese Academy of SciencesShanghai Institutes for Biological Sciences	PLOS ONE	Chemokine (C-C Motif) Ligand 20, a Potential Biomarker for Graves' Disease, Is Regulated by Osteopontin
qian jiang	China:Fudan Univ, Dept Ophthalmol, Eye & ENT Hosp, Shanghai 200433,Peoples R China. Fudan University	CURRENT EYE RESEARCH	Histopathology and Immunohistochemical Profile in Idiopathic Dacryoadenitis
qian jiang	China:Fudan Univ, Dept Ophthalmol, Eye & ENT Hosp, Shanghai 200433,Peoples R China. Fudan University	EUROPEAN JOURNAL OF OPHTHALMOLOGY	Multifocal visual evoked potentials in unilateral compressive optic neuropathy secondary to orbital tumors
qian jiang	China:Fudan Univ, Dept Ophthalmol, Eye & ENT Hosp, Shanghai 200433,Peoples R China. Fudan University	BRITISH JOURNAL OF OPHTHALMOLOGY	Treatment of orbital vascular malformations with intralesional injection of pingyangmycin
qin shangzhen	China:Wuhan Gen Hosp Guangzhou Command, Dept Neurosurg, PLA, Wuhan 430070,Peoples R China. 	INVESTIGATIVE OPHTHALMOLOGY & VISUAL SCIENCE	Enhancement of Axonal Regeneration of Retinal Ganglion Cells in Adult Rats by Etomidate: Involvement of Protein Kinase C
qin wei	China:Third Mil Med Univ, Oculoplast & Orbital Div, SW Eye Hosp SW Hosp, Chongqing 400038,Peoples R China. Third Military Medical University	OPHTHALMIC PLASTIC AND RECONSTRUCTIVE SURGERY	Lime Burns Resulting in Total Conjunctival Defect, Enucleation, and Fused Eyelids
qin wei	China:Third Mil Med Univ, Oculoplast & Orbital Div, SW Eye Hosp SW Hosp, Chongqing 400038,Peoples R China. Third Military Medical University	EUROPEAN JOURNAL OF OPHTHALMOLOGY	Adenoid cystic carcinoma of the lacrimal gland: CT and MRI findings
qin wei	China:Third Mil Med Univ, Oculoplast & Orbital Div, SW Eye Hosp SW Hosp, Chongqing 400038,Peoples R China. Third Military Medical University	EUROPEAN JOURNAL OF OPHTHALMOLOGY	Acute presentation of nasal-type natural killer/T-cell lymphoma of the orbit
qiu yiguo	China:Chongqing Med Univ, Dept Ophthalmol, Affiliated Hosp 1, Chongqing Key Lab Ophthalmol,Chongqing Eye Inst, Chongqing 400016,Peoples R China. Chongqing Medical University	CURRENT EYE RESEARCH	Effects of Three Commonly Used Anesthetics on Intraocular Pressure in Mouse
qu jia	China:Wenzhou Med Coll, Hosp Eye, Orbital & Oculoplast Dept, Wenzhou, Zhejiang,Peoples R China. Wenzhou Medical University	AMERICAN JOURNAL OF OPHTHALMOLOGY	Endoscopic Transethmoidal Approach with or without Medial Rectus Detachment for Orbital Apical Cavernous Hemangiomas
rao srinivask	China:Chinese Univ Hong Kong, Hong Kong Eye Hosp, Dept Ophthalmol & Visual Sci, Kowloon, Hong Kong,Peoples R China. Chinese University of Hong Kong	JOURNAL OF PEDIATRIC OPHTHALMOLOGY & STRABISMUS	Anterior segment ischemia after two-muscle surgery in a patient with radiation-treated nasopharyngeal carcinoma
ren bing	China:Chinese PLA 474th Hosp, Dept Ophthalmol, Urumuchi 830013, Xinjiang Uygur,Peoples R China. 	INTERNATIONAL JOURNAL OF OPHTHALMOLOGY	Comparative study of modified and conventional secondary hydroxyapatite orbital implantations
ren qiushi	China:Peking Univ, Dept Biomed Engn, Coll Engn, Beijing 100871,Peoples R China. Peking University	INVESTIGATIVE OPHTHALMOLOGY & VISUAL SCIENCE	Spatiotemporal Properties of Multipeaked Electrically Evoked Potentials Elicited by Penetrative Optic Nerve Stimulation in Rabbits
ren qiushi	China:Shanghai Jiao Tong Univ, Dept Biomed Engn, Inst Laser Med & Biophoton, Shanghai 200240,Peoples R China. Shanghai Jiao Tong University	GRAEFES ARCHIVE FOR CLINICAL AND EXPERIMENTAL OPHTHALMOLOGY	Intraorbital optic nerve stimulation with penetrating electrodes: in vivo electrophysiology study in rabbits
ren ruojin	China:Capital Med Univ, Beijing Tongren Eye Ctr, Beijing Tongren Hosp, Beijing Inst Ophthalmol, Beijing 100730,Peoples R China. Capital Medical University	ACTA OPHTHALMOLOGICA	Cerebrospinal fluid pressure in ocular hypertension
ren ruojin	China:Capital Med Univ, Beijing Tongren Eye Ctr, Beijing Tongren Hosp, Beijing Inst Ophthalmol, Beijing 100730,Peoples R China. Capital Medical University	OPHTHALMOLOGY	Orbital Cerebrospinal Fluid Space in Glaucoma: The Beijing Intracranial and Intraocular Pressure (iCOP) Study
shan fulan	China:GuangZhou Med Univ, Key Lab Neurogenet & Channelopathies Guangdong Pr, Guangzhou, Guangdong,Peoples R China. Guangzhou Medical University	PLOS ONE	Serum Thyroid-Stimulating Hormone and Anti-Thyroglobulin Antibody Are Independently Associated with Lesions in Spinal Cord in Central Nervous System Demyelinating Diseases
shao yi	China:Nanchang Univ, Dept Ophthalmol, Affiliated Hosp 1, Nanchang 330006, Jiangxi,Peoples R China. Nanchang University	INTERNATIONAL JOURNAL OF OPHTHALMOLOGY	Aerocyst urethral catheter insertion compared to expansion sponges application in external dacryocystorhinostomy
sheng li	China:Fudan Univ, Dept Endocrinol & Metab, Shanghai Peoples Hosp 5, Shanghai 200433,Peoples R China. Fudan University	PLOS ONE	Decrease in Proportion of CD19(+)CD24(hi)CD27(+) B Cells and Impairment of Their Suppressive Function in Graves' Disease
shi jieliang	China:Wenzhou Med Coll, Hosp Eye, Orbital & Oculoplast Dept, Wenzhou, Zhejiang,Peoples R China. Wenzhou Medical University	AMERICAN JOURNAL OF OPHTHALMOLOGY	Endoscopic Transethmoidal Approach with or without Medial Rectus Detachment for Orbital Apical Cavernous Hemangiomas
shi jitong	China:Capital Med Univ, Beijing Tongren Hosp, Beijing Tongren Eye Ctr, Beijing Inst Ophthalmol, Beijing,Peoples R China. Capital Medical University	GRAEFES ARCHIVE FOR CLINICAL AND EXPERIMENTAL OPHTHALMOLOGY	Epithelial tumors of the lacrimal gland in the Chinese: a clinicopathologic study of 298 patients
sitt cm	China:Chinese Univ Hong Kong, Prince Wales Hosp, Dept Imaging & Intervent Radiol, Shatin, Hong Kong,Peoples R China. Chinese University of Hong KongPrince of Wales Hospital	SEMINARS IN OPHTHALMOLOGY	Intraconal Orbital Dermoid Cyst in an Adult Patient: A Rare Location
siu yw	China:Chinese Univ Hong Kong, Prince Wales Hosp, Dept Imaging & Intervent Radiol, Shatin, Hong Kong,Peoples R China. Chinese University of Hong KongPrince of Wales Hospital	SEMINARS IN OPHTHALMOLOGY	Intraconal Orbital Dermoid Cyst in an Adult Patient: A Rare Location
so kwokfai	China:Univ Hong Kong, Li Ka Shing Fac Med, Dept Anat, Pokfulam, Hong Kong,Peoples R China. University of Hong Kong	OPHTHALMIC PLASTIC AND RECONSTRUCTIVE SURGERY	Surgical anatomy of the Chinese orbit
song delu	China:Chinese Acad Med Sci, Peking Union Med Coll Hosp, Dept Ophthalmol, Beijing 100730,Peoples R China. Chinese Academy of Medical Sciences - Peking Union Medical College	GRAEFES ARCHIVE FOR CLINICAL AND EXPERIMENTAL OPHTHALMOLOGY	Locally produced insulin-like growth factor-1 by orbital fibroblasts as implicative pathogenic factor rather than systemically circulated IGF-1 for patients with thyroid-associated ophthalmopathy
song guoxiang	China:Tianjin Med Univ, Hosp 2, Gamma Knife Ctr, Dept Ophthalmol, Tianjin 300211,Peoples R China. Tianjin Medical University	BRITISH JOURNAL OF OPHTHALMOLOGY	Gamma knife radiosurgery for primary orbital varices: a preliminary report
song zhiyi	China:Shanghai Jiao Tong Univ, Ruijin Hosp, Sch Med, State Key Lab Med Genom,Mol Med Ctr, Shanghai 200030,Peoples R China. Shanghai Jiao Tong University	PLOS ONE	A Refined Study of FCRL Genes from a Genome-Wide Association Study for Graves' Disease
su chang	China:Tianjin Med Univ, Hosp Eye, Coll Optometry, Inst Eye, Tianjin 300384,Peoples R China. Tianjin Medical University	GRAEFES ARCHIVE FOR CLINICAL AND EXPERIMENTAL OPHTHALMOLOGY	Reconstruction of orbital defects by implantation of antigen-free bovine cancellous bone scaffold combined with bone marrow mesenchymal stem cells in rats
su fan	China:Gen Hosp Armed Police Forces, Inst Orbital Dis, Beijing,Peoples R China. 	JOURNAL OF AAPOS	Orbital dermoid cyst with sinus tract mimicking ectopic cilia
sui ruifang	China:Beijing Union Med Coll Hosp, Peking Union Med Coll, Dept Ophthalmol, Beijing 100710,Peoples R China. Chinese Academy of Medical Sciences - Peking Union Medical College	EXPERIMENTAL EYE RESEARCH	Transthyretin Ala36Pro mutation in a Chinese pedigree of familial transthyretin amyloidosis with elevated vitreous and serum vascular endothelial growth factor
sun jingjing	China:Shanghai Jiao Tong Univ, Dept Biomed Engn, Sch Life Sci & Biotechnol, Shanghai 200240,Peoples R China. Shanghai Jiao Tong University	INVESTIGATIVE OPHTHALMOLOGY & VISUAL SCIENCE	Spatiotemporal Properties of Multipeaked Electrically Evoked Potentials Elicited by Penetrative Optic Nerve Stimulation in Rabbits
sun mingjie	China:Shanghai Jiao Tong Univ, Dept Biomed Engn, Inst Laser Med & Biophoton, Shanghai 200240,Peoples R China. Shanghai Jiao Tong University	GRAEFES ARCHIVE FOR CLINICAL AND EXPERIMENTAL OPHTHALMOLOGY	Intraorbital optic nerve stimulation with penetrating electrodes: in vivo electrophysiology study in rabbits
sun xianli	China:Capital Med Univ, Beijing Tongren Hosp, Beijing Tongren Eye Ctr, Beijing Inst Ophthalmol, Beijing,Peoples R China. Capital Medical University	GRAEFES ARCHIVE FOR CLINICAL AND EXPERIMENTAL OPHTHALMOLOGY	Epithelial tumors of the lacrimal gland in the Chinese: a clinicopathologic study of 298 patients
sun xinghuai	China:Fudan Univ, State Key Lab Med Neurobiol, Inst Brain Sci, Shanghai 200031,Peoples R China. Fudan University	JOURNAL OF GLAUCOMA	Parapapillary Gamma Zone Hole
sun yixuan	China:Tongji Univ, Sch Med, East Hosp, Dept Geriatr Med, Shanghai 200092,Peoples R China. Tongji University	PLOS ONE	Genetic Heterogeneity of Susceptibility Gene in Different Ethnic Populations: Refining Association Study of PTPN22 for Graves' Disease in a Chinese Han Population
sun yuying	China:Sun Yat Sen Univ, Zhongshan Ophthalm Ctr, State Key Lab Ophthalmol, Guangzhou 510060, Guangdong,Peoples R China. Sun Yat Sen University	MOLECULAR VISION	Retro-orbital injection of FITC-dextran is an effective and economical method for observing mouse retinal vessels
tang chong	China:Xian Elect Hosp, Dept Ultrasonog, Xian 710032, Shaanxi Provinc,Peoples R China. 	INTERNATIONAL JOURNAL OF OPHTHALMOLOGY	Data analysis of low dose multislice helical CT scan in orbital trauma
tang shibo	China:Sun Yat Sen Univ, Zhongshan Ophthalm Ctr, State Key Lab Ophthalmol, Guangzhou 510060, Guangdong,Peoples R China. Sun Yat Sen University	MOLECULAR VISION	Retro-orbital injection of FITC-dextran is an effective and economical method for observing mouse retinal vessels
tang weiqiang	China:Gen Hosp Peoples Liberat Army, Affiliated Hosp 1, Dept Ophthalmol, Beijing,Peoples R China. 	CLINICAL AND EXPERIMENTAL OPHTHALMOLOGY	Heparanase-1 and components of the hedgehog signalling pathway are increased in untreated alveolar orbital rhabdomyosarcoma
tian guogong	China:Capital Med Univ, Beijing Tongren Eye Ctr, Beijing Tongren Hosp, Beijing Inst Ophthalmol, Beijing 100730,Peoples R China. Capital Medical University	ACTA OPHTHALMOLOGICA	Cerebrospinal fluid pressure in ocular hypertension
tian rong	China:Beijing Union Med Coll Hosp, Peking Union Med Coll, Dept Ophthalmol, Beijing 100710,Peoples R China. Chinese Academy of Medical Sciences - Peking Union Medical College	EXPERIMENTAL EYE RESEARCH	Transthyretin Ala36Pro mutation in a Chinese pedigree of familial transthyretin amyloidosis with elevated vitreous and serum vascular endothelial growth factor
tian xinhua	China:Xiamen Univ, Dept Neurosurg, Zhongshan Hosp, Xiamen,Peoples R China. Xiamen University	CLINICAL AND EXPERIMENTAL OPHTHALMOLOGY	Transnasal transsphenoid approach: a minimally invasive approach for removal of cavernous haemangiomas located at inferomedial part of orbital apex
tian yanming	China:Hosp Chinese PLA, Chinese PLA Eye Ctr, Urumqi 830012, Xinjiang Uygur,Peoples R China. 	INTERNATIONAL JOURNAL OF OPHTHALMOLOGY	Adhesion of cavernous hemangioma in the orbit revealed by CT and MRI: analysis of 97 cases
tu yunhai	China:Wenzhou Med Coll, Affiliated Eye Hosp, Wenzhou City 325027, Zhejiang,Peoples R China. Wenzhou Medical University	OPHTHALMOLOGY	Endoscopic Transcaruncular Repair of Large Medial Orbital Wall Fractures Near the Orbital Apex
tu yunhai	China:Wenzhou Med Coll, Affiliated Eye Hosp, Wenzhou City 325027, Zhejiang,Peoples R China. Wenzhou Medical University	AMERICAN JOURNAL OF OPHTHALMOLOGY	Endoscopic Transethmoidal Approach with or without Medial Rectus Detachment for Orbital Apical Cavernous Hemangiomas
tu yunhai	China:Wenzhou Med Coll, Affiliated Eye Hosp, Wenzhou City 325027, Zhejiang,Peoples R China. Wenzhou Medical University	CLINICAL AND EXPERIMENTAL OPHTHALMOLOGY	Endoscopic transorbital approach for repair of cerebrospinal fluid leakage following removal of an orbito-cranial foreign body
wan sihai	China:So Med Univ, Nanfang Hosp, Dept Radiol, Guangzhou 510515, Guangdong,Peoples R China. Southern Medical University - China	INTERNATIONAL JOURNAL OF OPHTHALMOLOGY	Magnetic resonance diffusion tensor imaging and diffusion tensor tractography of human visual pathway
wang fang	China:Tongji Univ, Sch Med, Dept Ophthalmol, Shanghai Peoples Hosp 10, Shanghai 200072,Peoples R China. Tongji University	INVESTIGATIVE OPHTHALMOLOGY & VISUAL SCIENCE	Measurement of the Limbus-Insertion Distance in Adult Strabismus Patients with Anterior Segment Optical Coherence Tomography
wang haining	China:Shanghai Jiao Tong Univ, Ruijin Hosp, Sch Med, State Key Lab Med Genom,Mol Med Ctr, Shanghai 200030,Peoples R China. Shanghai Jiao Tong University	PLOS ONE	A Refined Study of FCRL Genes from a Genome-Wide Association Study for Graves' Disease
wang hao	China:Nanjing Med Univ, Hangzhou Peoples Hosp 1, Dept Neurosurg, Hangzhou 310006, Zhejiang,Peoples R China. Nanjing Medical University	JOURNAL OF NEURO-OPHTHALMOLOGY	Ectopic Pituitary Adenoma in the Spheno-Orbital Region
wang jing	China:Peking Univ, Dept Ophthalmol, Beijing Jishuitan Hosp, Hosp 4, Beijing 100871,Peoples R China. Peking University	AMERICAN JOURNAL OF OPHTHALMOLOGY	Digital Evaluation of Orbital Development in Chinese Children With Congenital Microphthalmia
wang jinghui	China:Capital Med Univ, Beijing Tongren Hosp, Beijing Tongren Eye Ctr, Beijing Ophthalmol & Visual Sci Key Lab, Beijing 100730,Peoples R China. Capital Medical University	JOURNAL OF AAPOS	Unilateral vertical retraction syndrome with orbital band
wang jiwei	China:Peoples Hosp Zhengzhou, Dept Radiol, Zhengzhou 450003, Henan Province,Peoples R China. 	INTERNATIONAL JOURNAL OF OPHTHALMOLOGY	Data analysis of low dose multislice helical CT scan in orbital trauma
wang jun	China:Beijing Normal Univ, State Key Lab Cognit Neurosci & Learning, Beijing 100875,Peoples R China. Beijing Normal University	PLOS ONE	Altered Topological Organization of White Matter Structural Networks in Patients with Neuromyelitis Optica
wang junming	China:Huazhong Univ Sci & Technol, Tongji Med Coll, Tongji Hosp, Dept Ophthalmol, Wuhan 430074,Peoples R China. Huazhong University of Science & Technology	OPHTHALMIC PLASTIC AND RECONSTRUCTIVE SURGERY	The Psychosocial Benefits of Secondary Hydroxyapatite Orbital Implant Insertion and Prosthesis Wearing for Patients With Anophthalmia
wang luman	China:Fudan Univ, Biotherapy Res Ctr, Shanghai Med Coll, Shanghai 200433,Peoples R China. Fudan University	PLOS ONE	Decrease in Proportion of CD19(+)CD24(hi)CD27(+) B Cells and Impairment of Their Suppressive Function in Graves' Disease
wang min	China:Fudan Univ, Dept Ophthalmol, Eye Ear Nose & Throat Hosp, Shanghai 200031,Peoples R China. Fudan University	EUROPEAN JOURNAL OF OPHTHALMOLOGY	Multifocal visual evoked potentials in unilateral compressive optic neuropathy secondary to orbital tumors
wang n	China:Capital Med Univ, Beijing Tongren Hosp, Beijing Tongren Eye Ctr, Beijing,Peoples R China. Capital Medical University	OPHTHALMOLOGICA	Effect of intraocular pressure on glaucomatous damage to the optic nerve
wang n	China:Capital Med Univ, Beijing Tongren Hosp, Beijing Tongren Eye Ctr, Beijing,Peoples R China. Capital Medical University	INVESTIGATIVE OPHTHALMOLOGY & VISUAL SCIENCE	Subfoveal Choroidal Thickness and Cerebrospinal Fluid Pressure: The Beijing Eye Study 2011
wang n	China:Capital Med Univ, Beijing Tongren Hosp, Beijing Tongren Eye Ctr, Beijing,Peoples R China. Capital Medical University	ACTA OPHTHALMOLOGICA	Cerebrospinal fluid pressure in ocular hypertension
wang n	China:Capital Med Univ, Beijing Tongren Hosp, Beijing Tongren Eye Ctr, Beijing,Peoples R China. Capital Medical University	OPHTHALMOLOGY	Orbital Cerebrospinal Fluid Space in Glaucoma: The Beijing Intracranial and Intraocular Pressure (iCOP) Study
wang n	China:Capital Med Univ, Beijing Tongren Hosp, Beijing Tongren Eye Ctr, Beijing,Peoples R China. Capital Medical University	OPHTHALMOLOGY	Orbital Cerebrospinal Fluid Space in Glaucoma Reply
wang n	China:Capital Med Univ, Beijing Tongren Hosp, Beijing Tongren Eye Ctr, Beijing,Peoples R China. Capital Medical University	JOURNAL OF AAPOS	Diagnosis and surgical treatment of unilateral restrictive hypotropia and esotropia
wang n	China:Capital Med Univ, Beijing Tongren Hosp, Beijing Tongren Eye Ctr, Beijing,Peoples R China. Capital Medical University	INTERNATIONAL JOURNAL OF OPHTHALMOLOGY	Dedifferentiated orbital liposarcoma: a case report
wang panfeng	China:Sun Yat Sen Univ, State Key Lab Ophthalmol, Zhongshan Ophthalm Ctr, Guangzhou 510060, Guangdong,Peoples R China. Sun Yat Sen University	ARCHIVES OF OPHTHALMOLOGY	Novel SOX2 mutation associated with ocular coloboma in a Chinese family
wang renyan	China:Chinese Acad Med Sci, Peking Union Med Coll Hosp, Dept Ophthalmol, Beijing 100730,Peoples R China. Chinese Academy of Medical Sciences - Peking Union Medical College	GRAEFES ARCHIVE FOR CLINICAL AND EXPERIMENTAL OPHTHALMOLOGY	Locally produced insulin-like growth factor-1 by orbital fibroblasts as implicative pathogenic factor rather than systemically circulated IGF-1 for patients with thyroid-associated ophthalmopathy
wang xinglin	China:Chinese Peoples Liberat Army Gen Hosp, Dept Phys Therapy, Beijing 100853,Peoples R China. 	INTERNATIONAL JOURNAL OF OPHTHALMOLOGY	A technique for periorbital syringomas: intralesional radiofrequency ablation
wang y	China:Armed Police Gen Hosp, Inst Orbital Dis, Beijing,Peoples R China. 	EYE	Orbital schwannomas: findings from magnetic resonance imaging in 62 cases
wang y	China:Armed Police Gen Hosp, Inst Orbital Dis, Beijing,Peoples R China. 	JAPANESE JOURNAL OF OPHTHALMOLOGY	Infrequent bilateral orbital tumors and simulating lesions: The experience of a Chinese institute
wang y	China:Armed Police Gen Hosp, Inst Orbital Dis, Beijing,Peoples R China. 	JOURNAL OF AAPOS	Orbital dermoid cyst with sinus tract mimicking ectopic cilia
wang yaxing	China:Capital Med Univ, Beijing Tongren Hosp, Beijing Ophthalmol & Visual Sci Key Lab, Beijing Inst Ophthalmol,Beijing Tongren Eye Ctr, Beijing,Peoples R China. Capital Medical University	INVESTIGATIVE OPHTHALMOLOGY & VISUAL SCIENCE	Subfoveal Choroidal Thickness and Cerebrospinal Fluid Pressure: The Beijing Eye Study 2011
wang ye	China:Jilin Univ, Hosp 1, Dept Cent Lab, Changchun 130023,Peoples R China. Jilin University	PLOS ONE	A High Frequency of Circulating Th22 and Th17 Cells in Patients with New Onset Graves' Disease
wang yefei	China:Shanghai Jiao Tong Univ, Sch Med, Peoples Hosp 9, Dept Ophthalmol, Shanghai 200011,Peoples R China. Shanghai Jiao Tong University	EXPERIMENTAL EYE RESEARCH	Insulin-like growth factor 1 promotes the proliferation and adipogenesis of orbital adipose-derived stromal cells in thyroid-associated ophthalmopathy
wang yefei	China:Shanghai Jiao Tong Univ, Sch Med, Peoples Hosp 9, Dept Ophthalmol, Shanghai 200011,Peoples R China. Shanghai Jiao Tong University	INVESTIGATIVE OPHTHALMOLOGY & VISUAL SCIENCE	In Vivo Efficacy of Bone Marrow Stromal Cells Coated with Beta-Tricalcium Phosphate for the Reconstruction of Orbital Defects in Canines
wang zhenchang	China:Capital Med Univ, Beijing Tongren Hosp, Beijing Tongren Med Imaging Ctr, Beijing,Peoples R China. Capital Medical University	JOURNAL OF AAPOS	Diagnosis and surgical treatment of unilateral restrictive hypotropia and esotropia
wang zhenchang	China:Capital Med Univ, Beijing Tongren Hosp, Beijing Tongren Med Imaging Ctr, Beijing,Peoples R China. Capital Medical University	JOURNAL OF AAPOS	Unilateral vertical retraction syndrome with orbital band
wang zhenchang	China:Capital Med Univ, Beijing Tongren Hosp, Beijing Tongren Med Imaging Ctr, Beijing,Peoples R China. Capital Medical University	AMERICAN JOURNAL OF OPHTHALMOLOGY	Digital Evaluation of Orbital Development in Chinese Children With Congenital Microphthalmia
wei ruili	China:Second Mil Med Univ, Shanghai Changzheng Hosp, Dept Ophthalmol, Shanghai 200003,Peoples R China. Second Military Medical University	INVESTIGATIVE OPHTHALMOLOGY & VISUAL SCIENCE	The Expression of Intercellular Adhesion Molecule-1 Induced by CD40-CD40L Ligand Signaling in Orbital Fibroblasts in Patients with Graves' Ophthalmopathy
wei ruili	China:Second Mil Med Univ, Shanghai Changzheng Hosp, Dept Ophthalmol, Shanghai 200003,Peoples R China. Second Military Medical University	OPHTHALMOLOGICA	The use of orbital radiotherapy for Graves' ophthalmopathy: Quantitative review of the evidence
wei wenbin	China:Capital Med Univ, Beijing Tongren Hosp, Beijing Tongren Eye Ctr, Beijing,Peoples R China. Capital Medical University	INVESTIGATIVE OPHTHALMOLOGY & VISUAL SCIENCE	Subfoveal Choroidal Thickness and Cerebrospinal Fluid Pressure: The Beijing Eye Study 2011
wiwanitkit viroj	China:Joseph Ayobabalola Univ, Ikeji Arakeji, Osun, Nigeria. 	CANADIAN JOURNAL OF OPHTHALMOLOGY-JOURNAL CANADIEN D OPHTALMOLOGIE	Re: Orbital sparganosis
wong wong	China:Chinese Univ Hong Kong, Hong Kong Eye Hosp, Dept Ophthalmol & Visual Sci, Kowloon, Hong Kong,Peoples R China. Chinese University of Hong Kong	INVESTIGATIVE OPHTHALMOLOGY & VISUAL SCIENCE	Association of CTLA-4 and IL-13 gene polymorphisms with Graves' disease and ophthalmopathy in Chinese children
wong hilda	China:Queen Mary Hosp, Dept Med, Div Haematol & Med Oncol, Hong Kong, Hong Kong,Peoples R China. University of Hong Kong	ACTA OPHTHALMOLOGICA	The ophthalmological complications of targeted agents in cancer therapy: what do we need to know as ophthalmologists?
woo georgec	China:Hong Kong Polytech Univ, Sch Optometry, Hong Kong, Hong Kong,Peoples R China. Hong Kong Polytechnic University	CLINICAL AND EXPERIMENTAL OPTOMETRY	Thyroid disease induced diplopia
wu guijun	China:So Med Univ, Nanfang Hosp, Dept Ophthalmol, Guangzhou 510515, Guangdong,Peoples R China. Southern Medical University - China	INTERNATIONAL JOURNAL OF OPHTHALMOLOGY	Magnetic resonance diffusion tensor imaging and diffusion tensor tractography of human visual pathway
wu kaijie	China:Shanghai Jiao Tong Univ, Dept Biomed Engn, Inst Laser Med & Biophoton, Shanghai 200240,Peoples R China. Shanghai Jiao Tong University	GRAEFES ARCHIVE FOR CLINICAL AND EXPERIMENTAL OPHTHALMOLOGY	Intraorbital optic nerve stimulation with penetrating electrodes: in vivo electrophysiology study in rabbits
wu qirong	China:Shanghai Jiao Tong Univ, Sch Med, Xinhua Hosp, Dept Ophthalmol, Shanghai 200092,Peoples R China. Shanghai Jiao Tong University	OPHTHALMOLOGY	Topical Anesthesia versus Regional Anesthesia for Cataract Surgery: A Meta-Analysis of Randomized Controlled Trials
wu qunying	China:Xingtai Eye Hosp, Xingtai,Peoples R China. 	CLINICAL AND EXPERIMENTAL OPHTHALMOLOGY	Endoscopic transorbital approach for repair of cerebrospinal fluid leakage following removal of an orbito-cranial foreign body
wu wencan	China:Wenzhou Med Coll, Affiliated Eye Hosp, Wenzhou City 325027, Zhejiang,Peoples R China. Wenzhou Medical University	OPHTHALMOLOGY	Endoscopic Transcaruncular Repair of Large Medial Orbital Wall Fractures Near the Orbital Apex
wu wencan	China:Wenzhou Med Coll, Affiliated Eye Hosp, Wenzhou City 325027, Zhejiang,Peoples R China. Wenzhou Medical University	CLINICAL AND EXPERIMENTAL OPHTHALMOLOGY	Endoscopic transorbital approach for repair of cerebrospinal fluid leakage following removal of an orbito-cranial foreign body
wu xiaoshan	China:Cent S Univ, Xiangya Hosp, Dept Oral & Maxillofacial Surg, Changsha 410008, Hunan,Peoples R China. Central South University	OPHTHALMIC PLASTIC AND RECONSTRUCTIVE SURGERY	Investigation of Anthropometric Measurements of Anatomic Structures of Orbital Soft Tissue in 102 Young Han Chinese Adults
wu yanan	China:Beijing Univ Technol, Coll Life Sci & Bioengn, Beijing,Peoples R China. Beijing University of Technology	PLOS ONE	Quantification of Epstein-Barr Virus DNA in Patients with Idiopathic Orbital Inflammatory Pseudotumor
wv wencan	China:Wenzhou Med Coll, Hosp Eye, Orbital & Oculoplast Dept, Wenzhou, Zhejiang,Peoples R China. Wenzhou Medical University	AMERICAN JOURNAL OF OPHTHALMOLOGY	Endoscopic Transethmoidal Approach with or without Medial Rectus Detachment for Orbital Apical Cavernous Hemangiomas
xia mingrui	China:Beijing Normal Univ, State Key Lab Cognit Neurosci & Learning, Beijing 100875,Peoples R China. Beijing Normal University	PLOS ONE	Altered Topological Organization of White Matter Structural Networks in Patients with Neuromyelitis Optica
xia yong	China:Sichuan Univ, Dept Neurosurg, W China Hosp, Chengdu 610041, Sichuan Provinc,Peoples R China. Sichuan University	MOLECULAR VISION	Retinal whole genome microarray analysis and early morphological changes in the optic nerves of monkeys after an intraorbital nerve irradiated injury
xian junfang	China:Capital Med Univ, Beijing Tongren Hosp, Dept Radiol, Beijing,Peoples R China. Capital Medical University	OPHTHALMOLOGY	Orbital Cerebrospinal Fluid Space in Glaucoma Reply
xian junfang	China:Capital Med Univ, Beijing Tongren Hosp, Dept Radiol, Beijing,Peoples R China. Capital Medical University	OPHTHALMOLOGY	Orbital Cerebrospinal Fluid Space in Glaucoma: The Beijing Intracranial and Intraocular Pressure (iCOP) Study
xiao caiwen	China:Shanghai Jiao Tong Univ, Sch Med, Peoples Hosp 9, Dept Ophthalmol, Shanghai 200011,Peoples R China. Shanghai Jiao Tong University	INVESTIGATIVE OPHTHALMOLOGY & VISUAL SCIENCE	In Vivo Efficacy of Bone Marrow Stromal Cells Coated with Beta-Tricalcium Phosphate for the Reconstruction of Orbital Defects in Canines
xiao lh	China:Armed Police Gen Hosp, Inst Orbital Dis, Beijing,Peoples R China. 	EYE	Orbital schwannomas: findings from magnetic resonance imaging in 62 cases
xiao lh	China:Armed Police Gen Hosp, Inst Orbital Dis, Beijing,Peoples R China. 	CLINICAL AND EXPERIMENTAL OPHTHALMOLOGY	Heparanase-1 and components of the hedgehog signalling pathway are increased in untreated alveolar orbital rhabdomyosarcoma
xiao lh	China:Armed Police Gen Hosp, Inst Orbital Dis, Beijing,Peoples R China. 	JAPANESE JOURNAL OF OPHTHALMOLOGY	Infrequent bilateral orbital tumors and simulating lesions: The experience of a Chinese institute
xiao lh	China:Armed Police Gen Hosp, Inst Orbital Dis, Beijing,Peoples R China. 	JOURNAL OF AAPOS	Orbital dermoid cyst with sinus tract mimicking ectopic cilia
xiao lh	China:Armed Police Gen Hosp, Inst Orbital Dis, Beijing,Peoples R China. 	INTERNATIONAL JOURNAL OF OPHTHALMOLOGY	Adhesion of cavernous hemangioma in the orbit revealed by CT and MRI: analysis of 97 cases
xiao xin	China:Peoples Hosp Guangxi Zhuang Autonomous Reg, Guangxi Ctr Visual Sci & Optometry, Nanning, Guangxi,Peoples R China. 	CURRENT EYE RESEARCH	Vision-Related Quality of Life Tends to be More Severely Impaired in Patients with Dysthyroid Optic Neuropathy
xiao ying	China:Tongji Univ, Sch Med, Dept Ophthalmol, Shanghai Peoples Hosp 10, Shanghai 200072,Peoples R China. Tongji University	INVESTIGATIVE OPHTHALMOLOGY & VISUAL SCIENCE	Measurement of the Limbus-Insertion Distance in Adult Strabismus Patients with Anterior Segment Optical Coherence Tomography
xie xiaobin	China:Capital Med Univ, Beijing Ophthalmol & Visual Sci Key Lab, Beijing Tongren Hosp, Beijing Tongren Eye Ctr, Beijing,Peoples R China. Capital Medical University	INVESTIGATIVE OPHTHALMOLOGY & VISUAL SCIENCE	Subfoveal Choroidal Thickness and Cerebrospinal Fluid Pressure: The Beijing Eye Study 2011
xie xiaobin	China:Capital Med Univ, Beijing Ophthalmol & Visual Sci Key Lab, Beijing Tongren Hosp, Beijing Tongren Eye Ctr, Beijing,Peoples R China. Capital Medical University	OPHTHALMOLOGY	Orbital Cerebrospinal Fluid Space in Glaucoma: The Beijing Intracranial and Intraocular Pressure (iCOP) Study
xie xiaobin	China:Capital Med Univ, Beijing Ophthalmol & Visual Sci Key Lab, Beijing Tongren Hosp, Beijing Tongren Eye Ctr, Beijing,Peoples R China. Capital Medical University	OPHTHALMOLOGY	Orbital Cerebrospinal Fluid Space in Glaucoma Reply
xie zhengfu	China:Guangxi Med Univ, Dept Geriatr & Gerontol, Affiliated Hosp 1, Nanning,Peoples R China. Guangxi Medical University	PLOS ONE	Association between the IL1B (-511), IL1B (+3954), IL1RN (VNTR) Polymorphisms and Graves' Disease Risk: A Meta-Analysis of 11 Case-Control Studies
xiong li	China:Sichuan Univ, Dept Neurosurg, W China Hosp, Chengdu 610041, Sichuan Provinc,Peoples R China. Sichuan University	MOLECULAR VISION	Retinal whole genome microarray analysis and early morphological changes in the optic nerves of monkeys after an intraorbital nerve irradiated injury
xu bainan	China:Chinese Peoples Liberat Army Gen Hosp, Dept Neurosurg, Beijing,Peoples R China. 	CLINICAL AND EXPERIMENTAL OPHTHALMOLOGY	Transnasal transsphenoid approach: a minimally invasive approach for removal of cavernous haemangiomas located at inferomedial part of orbital apex
xu bei	China:Cent S Univ, Dept Ophthalmol, Xiangya Hosp, Changsha 410008, Hunan,Peoples R China. Central South University	INTERNATIONAL JOURNAL OF OPHTHALMOLOGY	Treatment of traumatic globe dislocated completely into the maxillary sinus
xu bingchuan	China:Jilin Univ, Hosp 1, Dept Cent Lab, Changchun 130023,Peoples R China. Jilin University	PLOS ONE	A High Frequency of Circulating Th22 and Th17 Cells in Patients with New Onset Graves' Disease
xu desheng	China:Tianjin Med Univ, Hosp 2, Gamma Knife Ctr, Dept Neurosurg, Tianjin 300211,Peoples R China. Tianjin Medical University	BRITISH JOURNAL OF OPHTHALMOLOGY	Gamma knife radiosurgery for primary orbital varices: a preliminary report
xu dongdong	China:Beijing Union Med Coll Hosp, Div Ophthalmol, Dept Ophthalmol, Beijing 100730,Peoples R China. Chinese Academy of Medical Sciences - Peking Union Medical College	CANADIAN JOURNAL OF OPHTHALMOLOGY-JOURNAL CANADIEN D OPHTALMOLOGIE	Repeated triamcinolone acetonide injection in the treatment of upper-lid retraction in patients with thyroid-associated ophthalmopathy
xu dongdong	China:Beijing Union Med Coll Hosp, Div Ophthalmol, Dept Ophthalmol, Beijing 100730,Peoples R China. Chinese Academy of Medical Sciences - Peking Union Medical College	BRITISH JOURNAL OF OPHTHALMOLOGY	Infratemporal fossa fat enlargement in chronic maxillary atelectasis
xu guozheng	China:Wuhan Gen Hosp Guangzhou Command, Dept Neurosurg, PLA, Wuhan 430070,Peoples R China. 	INVESTIGATIVE OPHTHALMOLOGY & VISUAL SCIENCE	Enhancement of Axonal Regeneration of Retinal Ganglion Cells in Adult Rats by Etomidate: Involvement of Protein Kinase C
xu jianping	China:Capital Med Univ, Beijing Tongren Hosp, Beijing Tongren Eye Ctr, Beijing Inst Ophthalmol, Beijing,Peoples R China. Capital Medical University	GRAEFES ARCHIVE FOR CLINICAL AND EXPERIMENTAL OPHTHALMOLOGY	Epithelial tumors of the lacrimal gland in the Chinese: a clinicopathologic study of 298 patients
xu jiong	China:Fudan Univ, Dept Endocrinol & Metab, Shanghai Peoples Hosp 5, Shanghai 200433,Peoples R China. Fudan University	PLOS ONE	Decrease in Proportion of CD19(+)CD24(hi)CD27(+) B Cells and Impairment of Their Suppressive Function in Graves' Disease
xu l	China:Capital Univ Med Sci, Beijing Tongren Hosp, Beijing Inst Ophthalmol, Beijing,Peoples R China. Capital Medical University	EYE	Histological changes of high axial myopia
xu l	China:Capital Univ Med Sci, Beijing Tongren Hosp, Beijing Inst Ophthalmol, Beijing,Peoples R China. Capital Medical University	INVESTIGATIVE OPHTHALMOLOGY & VISUAL SCIENCE	Subfoveal Choroidal Thickness and Cerebrospinal Fluid Pressure: The Beijing Eye Study 2011
xu nuo	China:Fujian Prov Hosp, Fujian Prov Clin Coll Med, Dept Ophthalmol, Fuzhou, Fujian,Peoples R China. 	GRAEFES ARCHIVE FOR CLINICAL AND EXPERIMENTAL OPHTHALMOLOGY	Inflammatory cytokine profiles in the tears of thyroid-associated ophthalmopathy
xu wei	China:Fudan Univ, Dept Neurosurg, Huashan Hosp, Shanghai 200433,Peoples R China. Fudan University	JOURNAL OF NEURO-OPHTHALMOLOGY	Ectopic Pituitary Adenoma in the Spheno-Orbital Region
xu xueliang	China:Cent S Univ, Dept Ophthalmol, Xiangya Hosp, Changsha 410008, Hunan,Peoples R China. Central South University	INTERNATIONAL JOURNAL OF OPHTHALMOLOGY	Treatment of traumatic globe dislocated completely into the maxillary sinus
xu xueliang	China:Cent S Univ, Dept Ophthalmol, Xiangya Hosp, Changsha 410008, Hunan,Peoples R China. Central South University	INTERNATIONAL JOURNAL OF OPHTHALMOLOGY	Reconstruction of complex orbital fracture with titanium implants
xu xueliang	China:Cent S Univ, Dept Ophthalmol, Xiangya Hosp, Changsha 410008, Hunan,Peoples R China. Central South University	INTERNATIONAL JOURNAL OF OPHTHALMOLOGY	Transcranial surgery through pterional approach for removal of cranio -orbital tumors by an interdisciplinary team of nurosurgeons and ophthalmologists
xu xun	China:Shanghai Jiao Tong Univ, Dept Ophthalmol, Affiliated Shanghai Peoples Hosp 1, Shanghai 200080,Peoples R China. Shanghai Jiao Tong University	GRAEFES ARCHIVE FOR CLINICAL AND EXPERIMENTAL OPHTHALMOLOGY	Intraorbital optic nerve stimulation with penetrating electrodes: in vivo electrophysiology study in rabbits
xu zhaoxi	China:Wuhan Gen Hosp Guangzhou Command, Dept Neurosurg, PLA, Wuhan 430070,Peoples R China. 	INVESTIGATIVE OPHTHALMOLOGY & VISUAL SCIENCE	Enhancement of Axonal Regeneration of Retinal Ganglion Cells in Adult Rats by Etomidate: Involvement of Protein Kinase C
xue kang	China:Fudan Univ, Dept Ophthalmol, Eye Ear Nose & Throat Hosp, Shanghai 200031,Peoples R China. Fudan University	EUROPEAN JOURNAL OF OPHTHALMOLOGY	Multifocal visual evoked potentials in unilateral compressive optic neuropathy secondary to orbital tumors
xue liqiong	China:Shanghai Jiao Tong Univ, Ruijin Hosp, Sch Med, State Key Lab Med Genom,Mol Med Ctr, Shanghai 200030,Peoples R China. Shanghai Jiao Tong University	PLOS ONE	A Refined Study of FCRL Genes from a Genome-Wide Association Study for Graves' Disease
xue liqiong	China:Shanghai Jiao Tong Univ, Ruijin Hosp, Sch Med, State Key Lab Med Genom,Mol Med Ctr, Shanghai 200030,Peoples R China. Shanghai Jiao Tong University	PLOS ONE	Genetic Heterogeneity of Susceptibility Gene in Different Ethnic Populations: Refining Association Study of PTPN22 for Graves' Disease in a Chinese Han Population
yan jia	China:First Peoples Hosp, Dept Ophthalmol, Shaoyang 422001, Hunan,Peoples R China. 	INTERNATIONAL JOURNAL OF OPHTHALMOLOGY	Treatment of traumatic globe dislocated completely into the maxillary sinus
yan jianhua	China:Sun Yat Sen Univ, Zhongshan Ophthalm Ctr, State Key Lab Ophthalmol, Guangzhou 510060, Guangdong,Peoples R China. Sun Yat Sen University	GRAEFES ARCHIVE FOR CLINICAL AND EXPERIMENTAL OPHTHALMOLOGY	Metastatic orbital tumors in southern China during an 18-year period
yang chunbo	China:Tianjin Med Univ, Hosp Eye, Coll Optometry, Inst Eye, Tianjin 300384,Peoples R China. Tianjin Medical University	GRAEFES ARCHIVE FOR CLINICAL AND EXPERIMENTAL OPHTHALMOLOGY	Reconstruction of orbital defects by implantation of antigen-free bovine cancellous bone scaffold combined with bone marrow mesenchymal stem cells in rats
yang d	China:Capital Med Univ, Beijing Tongren Hosp, Beijing Tongren Eye Ctr, Beijing,Peoples R China. Capital Medical University	OPHTHALMOLOGICA	Effect of intraocular pressure on glaucomatous damage to the optic nerve
yang d	China:Capital Med Univ, Beijing Tongren Hosp, Beijing Tongren Eye Ctr, Beijing,Peoples R China. Capital Medical University	INVESTIGATIVE OPHTHALMOLOGY & VISUAL SCIENCE	Subfoveal Choroidal Thickness and Cerebrospinal Fluid Pressure: The Beijing Eye Study 2011
yang d	China:Capital Med Univ, Beijing Tongren Hosp, Beijing Tongren Eye Ctr, Beijing,Peoples R China. Capital Medical University	OPHTHALMOLOGY	Orbital Cerebrospinal Fluid Space in Glaucoma: The Beijing Intracranial and Intraocular Pressure (iCOP) Study
yang d	China:Capital Med Univ, Beijing Tongren Hosp, Beijing Tongren Eye Ctr, Beijing,Peoples R China. Capital Medical University	OPHTHALMOLOGY	Orbital Cerebrospinal Fluid Space in Glaucoma Reply
yang gjang	China:Capital Med Univ, Beijing Tongren Eye Ctr, Beijing Tongren Hosp, Beijing Ophthalmol & Visual Sci Key Lab, Beijing 100730,Peoples R China. Capital Medical University	AMERICAN JOURNAL OF OPHTHALMOLOGY	Digital Evaluation of Orbital Development in Chinese Children With Congenital Microphthalmia
yang hongxia	China:Chongqing Med Univ, Dept Ophthalmol, Affiliated Hosp 1, Chongqing Key Lab Ophthalmol,Chongqing Eye Inst, Chongqing 400016,Peoples R China. Chongqing Medical University	CURRENT EYE RESEARCH	Effects of Three Commonly Used Anesthetics on Intraocular Pressure in Mouse
yang huasheng	China:Sun Yat Sen Univ, State Key Lab Ophthalmol, Zhongshan Ophthalm Ctr, Guangzhou 510060, Guangdong,Peoples R China. Sun Yat Sen University	CANADIAN JOURNAL OF OPHTHALMOLOGY-JOURNAL CANADIEN D OPHTALMOLOGIE	Clinical features of 8 cases of orbital sparganosis in southern China
yang huasheng	China:Sun Yat Sen Univ, State Key Lab Ophthalmol, Zhongshan Ophthalm Ctr, Guangzhou 510060, Guangdong,Peoples R China. Sun Yat Sen University	AMERICAN JOURNAL OF OPHTHALMOLOGY	A Modified Evisceration Technique with Scleral Quadrisection and Porous Polyethylene Implantation
yang huasheng	China:Sun Yat Sen Univ, State Key Lab Ophthalmol, Zhongshan Ophthalm Ctr, Guangzhou 510060, Guangdong,Peoples R China. Sun Yat Sen University	CURRENT EYE RESEARCH	Vision-Related Quality of Life Tends to be More Severely Impaired in Patients with Dysthyroid Optic Neuropathy
yang liangchun	China:Cent S Univ, Dept Pediat, Xiangya Hosp, Changsha 410011, Hunan,Peoples R China. Central South University	JOURNAL OF AAPOS	Primary synovial sarcoma in the orbit
yang lu	China:Nanchang Univ, Dept Ophthalmol, Affiliated Hosp 1, Nanchang 330006, Jiangxi,Peoples R China. Nanchang University	INTERNATIONAL JOURNAL OF OPHTHALMOLOGY	Aerocyst urethral catheter insertion compared to expansion sponges application in external dacryocystorhinostomy
yang ning	China:GuangZhou Med Univ, Affiliated Hosp 5, Dept Neurol, Guangzhou, Guangdong,Peoples R China. Guangzhou Medical University	PLOS ONE	Serum Thyroid-Stimulating Hormone and Anti-Thyroglobulin Antibody Are Independently Associated with Lesions in Spinal Cord in Central Nervous System Demyelinating Diseases
yang shaoying	China:Shanghai Jiao Tong Univ, Ruijin Hosp, Sch Med, State Key Lab Med Genom,Mol Med Ctr, Shanghai 200030,Peoples R China. Shanghai Jiao Tong University	PLOS ONE	A Refined Study of FCRL Genes from a Genome-Wide Association Study for Graves' Disease
yang shaoying	China:Shanghai Jiao Tong Univ, Ruijin Hosp, Sch Med, State Key Lab Med Genom,Mol Med Ctr, Shanghai 200030,Peoples R China. Shanghai Jiao Tong University	PLOS ONE	Genetic Heterogeneity of Susceptibility Gene in Different Ethnic Populations: Refining Association Study of PTPN22 for Graves' Disease in a Chinese Han Population
yang xinji	China:Chinese Armed Police Gen Hosp, Inst Orbital Dis, Beijing,Peoples R China. 	PLOS ONE	Quantification of Epstein-Barr Virus DNA in Patients with Idiopathic Orbital Inflammatory Pseudotumor
yau kin	China:Tung Wah Eastern Hosp, Dept Ophthalmol, Hong Kong, Hong Kong,Peoples R China. 	INTERNATIONAL JOURNAL OF OPHTHALMOLOGY	Clinicopathological survey of 23 patients with lacrimal fossa lesions in Hong Kong
yau thomas	China:Queen Mary Hosp, Dept Med, Div Haematol & Med Oncol, Hong Kong, Hong Kong,Peoples R China. University of Hong Kong	ACTA OPHTHALMOLOGICA	The ophthalmological complications of targeted agents in cancer therapy: what do we need to know as ophthalmologists?
ye huijing	China:Sun Yat Sen Univ, State Key Lab Ophthalmol, Zhongshan Ophthalm Ctr, Guangzhou 510060, Guangdong,Peoples R China. Sun Yat Sen University	CANADIAN JOURNAL OF OPHTHALMOLOGY-JOURNAL CANADIEN D OPHTALMOLOGIE	Clinical features of 8 cases of orbital sparganosis in southern China
ye huijing	China:Sun Yat Sen Univ, State Key Lab Ophthalmol, Zhongshan Ophthalm Ctr, Guangzhou 510060, Guangdong,Peoples R China. Sun Yat Sen University	CURRENT EYE RESEARCH	Vision-Related Quality of Life Tends to be More Severely Impaired in Patients with Dysthyroid Optic Neuropathy
ye jing	China:Capital Med Univ, Dept Neurol, Xuanwu Hosp, Beijing,Peoples R China. Capital Medical University	PLOS ONE	Altered Topological Organization of White Matter Structural Networks in Patients with Neuromyelitis Optica
ye xinhai	China:Tongji Univ, Sch Med, Dept Ophthalmol, Shanghai Peoples Hosp 10, Shanghai 200072,Peoples R China. Tongji University	INVESTIGATIVE OPHTHALMOLOGY & VISUAL SCIENCE	Measurement of the Limbus-Insertion Distance in Adult Strabismus Patients with Anterior Segment Optical Coherence Tomography
yi junhui	China:Cent S Univ, Dept Ophthalmol, Affiliated Xiangya Hosp 3, Changsha, Hunan,Peoples R China. Central South University	ARCHIVES OF OPHTHALMOLOGY	Novel SOX2 mutation associated with ocular coloboma in a Chinese family
yi wenshu	China:Cent S Univ, Xiangya Hosp, Dept Ophthalmol, Changsha 410008, Hunan,Peoples R China. Central South University	INTERNATIONAL JOURNAL OF OPHTHALMOLOGY	Reconstruction of complex orbital fracture with titanium implants
yick yick	China:Chinese Univ Hong Kong, Hong Kong Eye Hosp, Dept Ophthalmol & Visual Sci, Kowloon, Hong Kong,Peoples R China. Chinese University of Hong Kong	JOURNAL OF PEDIATRIC OPHTHALMOLOGY & STRABISMUS	Anterior segment ischemia after two-muscle surgery in a patient with radiation-treated nasopharyngeal carcinoma
yin xiaohui	China:Tianjin Med Univ, Gen Hosp, Dept Radiol, Tianjin 300203,Peoples R China. Tianjin Medical University	BRITISH JOURNAL OF OPHTHALMOLOGY	Grey and white matter changes in children with monocular amblyopia: voxel-based morphometry and diffusion tensor imaging study
yin zhengqin	China:Third Mil Med Univ, SW Eye Hosp, Southwest Hosp, Chongqing 400038,Peoples R China. Third Military Medical University	EUROPEAN JOURNAL OF OPHTHALMOLOGY	Adenoid cystic carcinoma of the lacrimal gland: CT and MRI findings
yin zhengqin	China:Third Mil Med Univ, SW Eye Hosp, Southwest Hosp, Chongqing 400038,Peoples R China. Third Military Medical University	EUROPEAN JOURNAL OF OPHTHALMOLOGY	Acute presentation of nasal-type natural killer/T-cell lymphoma of the orbit
yip yip	China:Chinese Univ Hong Kong, Hong Kong Eye Hosp, Dept Ophthalmol & Visual Sci, Kowloon, Hong Kong,Peoples R China. Chinese University of Hong Kong	JOURNAL OF PEDIATRIC OPHTHALMOLOGY & STRABISMUS	Anterior segment ischemia after two-muscle surgery in a patient with radiation-treated nasopharyngeal carcinoma
you chao	China:Sichuan Univ, Dept Neurosurg, W China Hosp, Chengdu 610041, Sichuan Provinc,Peoples R China. Sichuan University	MOLECULAR VISION	Retinal whole genome microarray analysis and early morphological changes in the optic nerves of monkeys after an intraorbital nerve irradiated injury
you qisheng	China:Capital Med Univ, Beijing Tongren Hosp, Beijing Ophthalmol & Visual Sci Key Lab, Beijing Inst Ophthalmol,Beijing Tongren Eye Ctr, Beijing,Peoples R China. Capital Medical University	INVESTIGATIVE OPHTHALMOLOGY & VISUAL SCIENCE	Subfoveal Choroidal Thickness and Cerebrospinal Fluid Pressure: The Beijing Eye Study 2011
yu yu	China:Chinese Univ Hong Kong, Hong Kong Eye Hosp, Dept Ophthalmol & Visual Sci, Kowloon, Hong Kong,Peoples R China. Chinese University of Hong Kong	JOURNAL OF PEDIATRIC OPHTHALMOLOGY & STRABISMUS	Anterior segment ischemia after two-muscle surgery in a patient with radiation-treated nasopharyngeal carcinoma
yu chunshui	China:Capital Med Univ, Dept Radiol, Xuanwu Hosp, Beijing,Peoples R China. Capital Medical University	PLOS ONE	Altered Topological Organization of White Matter Structural Networks in Patients with Neuromyelitis Optica
yu gang	China:Capital Med Univ, Beijing Childrens Hosp, Beijing,Peoples R China. Capital Medical University	JOURNAL OF AAPOS	Diagnosis and surgical treatment of unilateral restrictive hypotropia and esotropia
yu honghua	China:Sun Yat Sen Univ, Zhongshan Ophthalm Ctr, State Key Lab Ophthalmol, Guangzhou 510060, Guangdong,Peoples R China. Sun Yat Sen University	MOLECULAR VISION	Retro-orbital injection of FITC-dextran is an effective and economical method for observing mouse retinal vessels
yu meili	China:Tianjin Med Univ, Tianjin Cent Hosp 3, Tianjin Key Lab Artificial Cells, Tianjin 300170,Peoples R China. Tianjin Medical University	GRAEFES ARCHIVE FOR CLINICAL AND EXPERIMENTAL OPHTHALMOLOGY	Reconstruction of orbital defects by implantation of antigen-free bovine cancellous bone scaffold combined with bone marrow mesenchymal stem cells in rats
yu min	China:Tianjin Med Univ, Sch Publ Hlth, Tianjin 300070,Peoples R China. Chinese Academy of Medical Sciences - Peking Union Medical CollegeUnion School of Public Health - PUMCTianjin Medical University	GRAEFES ARCHIVE FOR CLINICAL AND EXPERIMENTAL OPHTHALMOLOGY	Reconstruction of orbital defects by implantation of antigen-free bovine cancellous bone scaffold combined with bone marrow mesenchymal stem cells in rats
yu shasha	China:Shanghai Jiao Tong Univ, Ruijin Hosp, State Key Lab Med Genom, Sch Med, Shanghai 200030,Peoples R China. Shanghai Jiao Tong University	PLOS ONE	Genetic Heterogeneity of Susceptibility Gene in Different Ethnic Populations: Refining Association Study of PTPN22 for Graves' Disease in a Chinese Han Population
yu wl	China:Chinese Univ Hong Kong, Prince Wales Hosp, Dept Imaging & Intervent Radiol, Shatin, Hong Kong,Peoples R China. Chinese University of Hong KongPrince of Wales Hospital	SEMINARS IN OPHTHALMOLOGY	Intraconal Orbital Dermoid Cyst in an Adult Patient: A Rare Location
yu wenhua	China:Nanjing Med Univ, Hangzhou Peoples Hosp 1, Dept Neurosurg, Hangzhou 310006, Zhejiang,Peoples R China. Nanjing Medical University	JOURNAL OF NEURO-OPHTHALMOLOGY	Ectopic Pituitary Adenoma in the Spheno-Orbital Region
yu yan	China:Cent S Univ, Dept Pathol, Xiangya Hosp, Changsha 410011, Hunan,Peoples R China. Central South University	JOURNAL OF AAPOS	Primary synovial sarcoma in the orbit
yu yangyang	China:Sun Yat Sen Univ, Zhongshan Ophthal Ctr, Guangzhou 510060, Guangdong,Peoples R China. Sun Yat Sen University	AMERICAN JOURNAL OF OPHTHALMOLOGY	A Modified Evisceration Technique with Scleral Quadrisection and Porous Polyethylene Implantation
yu yao	China:So Med Univ, Dept Endocrinol, Hosp Nanchang 3, Affiliated Nanchang Hosp, Nanchang 330009, Jiangxi,Peoples R China. Southern Medical University - China	INTERNATIONAL JOURNAL OF OPHTHALMOLOGY	Aerocyst urethral catheter insertion compared to expansion sponges application in external dacryocystorhinostomy
yuan jianhua	China:Zhejiang Prov Peoples Hosp, Dept Radiol, Hangzhou, Zhejiang,Peoples R China. 	PLOS ONE	Idiopathic Orbital Inflammation Syndrome with Retro-Orbital Involvement: A Retrospective Study of Eight Patients
yuan yifei	China:Fudan Univ, Dept Ophthalmol, Eye Ear Nose & Throat Hosp, Shanghai 200031,Peoples R China. Fudan University	EUROPEAN JOURNAL OF OPHTHALMOLOGY	Multifocal visual evoked potentials in unilateral compressive optic neuropathy secondary to orbital tumors
yuan yifei	China:Fudan Univ, Dept Ophthalmol, Eye Ear Nose & Throat Hosp, Shanghai 200031,Peoples R China. Fudan University	BRITISH JOURNAL OF OPHTHALMOLOGY	Treatment of orbital vascular malformations with intralesional injection of pingyangmycin
yue han	China:Fudan Univ, Eye & ENT Hosp, Dept Ophthalmol, Shanghai 200031,Peoples R China. Fudan University	BRITISH JOURNAL OF OPHTHALMOLOGY	Treatment of orbital vascular malformations with intralesional injection of pingyangmycin
yuen yuen	China:Chinese Univ Hong Kong, Dept Ophthalmol & Visual Sci, Hong Kong Eye Hosp, Kowloon, Hong Kong,Peoples R China. Chinese University of Hong Kong	EUROPEAN JOURNAL OF OPHTHALMOLOGY	Late leakage of filtering bleb in a patient with orbital pseudotumor
yuen yuen	China:Chinese Univ Hong Kong, Dept Ophthalmol & Visual Sci, Hong Kong Eye Hosp, Kowloon, Hong Kong,Peoples R China. Chinese University of Hong Kong	OPHTHALMIC PLASTIC AND RECONSTRUCTIVE SURGERY	Surgical anatomy of the Chinese orbit
yuen yuen	China:Chinese Univ Hong Kong, Dept Ophthalmol & Visual Sci, Hong Kong Eye Hosp, Kowloon, Hong Kong,Peoples R China. Chinese University of Hong Kong	OPHTHALMIC PLASTIC AND RECONSTRUCTIVE SURGERY	Inferonasal Prolapsed Orbital Fat: Report of a Case and Review of Literature
yuen yuen	China:Chinese Univ Hong Kong, Dept Ophthalmol & Visual Sci, Hong Kong Eye Hosp, Kowloon, Hong Kong,Peoples R China. Chinese University of Hong Kong	OPHTHALMIC PLASTIC AND RECONSTRUCTIVE SURGERY	Late-onset occult cerebrospinal fluid leakage after orbital exenteration
zeng changhong	China:Sichuan Univ, W China Hosp, Dept Ophthalmol, Chengdu 610041,Peoples R China. Sichuan University	OPHTHALMOLOGICA	Clinical and Pathological Observation and Treatment of Chronic Orbital Osteomyelitis
zeng jie	China:Capital Med Univ, Beijing Tongren Hosp, Beijing Tongren Eye Ctr, Beijing Inst Ophthalmol, Beijing,Peoples R China. Capital Medical University	GRAEFES ARCHIVE FOR CLINICAL AND EXPERIMENTAL OPHTHALMOLOGY	Epithelial tumors of the lacrimal gland in the Chinese: a clinicopathologic study of 298 patients
zeng yi	China:Chinese Ctr Dis Control & Prevent, Beijing,Peoples R China. Chinese Center for Disease Control & Prevention	PLOS ONE	Quantification of Epstein-Barr Virus DNA in Patients with Idiopathic Orbital Inflammatory Pseudotumor
zha bingbing	China:Fudan Univ, Dept Endocrinol & Metab, Shanghai Peoples Hosp 5, Shanghai 200433,Peoples R China. Fudan University	PLOS ONE	Decrease in Proportion of CD19(+)CD24(hi)CD27(+) B Cells and Impairment of Their Suppressive Function in Graves' Disease
zhan ming	China:Shanghai Jiao Tong Univ, Ruijin Hosp, Sch Med, State Key Lab Med Genom,Mol Med Ctr, Shanghai 200030,Peoples R China. Shanghai Jiao Tong University	PLOS ONE	A Refined Study of FCRL Genes from a Genome-Wide Association Study for Graves' Disease
zhang bin	China:GuangZhou Med Univ, Key Lab Neurogenet & Channelopathies Guangdong Pr, Guangzhou, Guangdong,Peoples R China. Guangzhou Medical University	PLOS ONE	Serum Thyroid-Stimulating Hormone and Anti-Thyroglobulin Antibody Are Independently Associated with Lesions in Spinal Cord in Central Nervous System Demyelinating Diseases
zhang fanghua	China:Capital Med Univ, Beijing Tongren Hosp, Beijing Tongren Eye Ctr, Beijing Ophthalmol & Visual Sci Key Lab, Beijing 100730,Peoples R China. Capital Medical University	JOURNAL OF AAPOS	Unilateral vertical retraction syndrome with orbital band
zhang fulin	China:Fudan Univ, Dept Pathol, Huashan Hosp, Shanghai 200433,Peoples R China. Fudan University	JOURNAL OF NEURO-OPHTHALMOLOGY	Ectopic Pituitary Adenoma in the Spheno-Orbital Region
zhang hong	China:Huazhong Univ Sci & Technol, Tongji Med Coll, Tongji Hosp, Dept Ophthalmol, Wuhan 430074,Peoples R China. Huazhong University of Science & Technology	OPHTHALMIC PLASTIC AND RECONSTRUCTIVE SURGERY	The Psychosocial Benefits of Secondary Hydroxyapatite Orbital Implant Insertion and Prosthesis Wearing for Patients With Anophthalmia
zhang jingxue	China:Capital Med Univ, Beijing Tongren Hosp, Beijing Tongren Eye Ctr, Beijing Ophthalmol & Vis Sci Key Lab, Beijing,Peoples R China. Capital Medical University	PLOS ONE	Quantification of Epstein-Barr Virus DNA in Patients with Idiopathic Orbital Inflammatory Pseudotumor
zhang jingxue	China:Capital Med Univ, Beijing Tongren Hosp, Beijing Tongren Eye Ctr, Beijing Ophthalmol & Vis Sci Key Lab, Beijing,Peoples R China. Capital Medical University	INTERNATIONAL JOURNAL OF OPHTHALMOLOGY	Dedifferentiated orbital liposarcoma: a case report
zhang leng	China:Tradit Chinese Med Hosp Dalian, Dept Phys Therapy, Dalian 116013, Shandong,Peoples R China. 	INTERNATIONAL JOURNAL OF OPHTHALMOLOGY	A technique for periorbital syringomas: intralesional radiofrequency ablation
zhang maonian	China:Chinese Peoples Liberat Army Gen Hosp, Dept Ophthalmol, Beijing 100853,Peoples R China. 	INTERNATIONAL JOURNAL OF OPHTHALMOLOGY	Comparative study of modified and conventional secondary hydroxyapatite orbital implantations
zhang mingzhi	China:Joint Shantou Int Eye Ctr, Shantou, Guangdong,Peoples R China. 	PLOS ONE	Epidemiology of Pediatric Ocular Trauma in the Chaoshan Region, China, 2001-2010
zhang qiao	China:Sichuan Univ, Dept Neurosurg, W China Hosp, Chengdu 610041, Sichuan Provinc,Peoples R China. Sichuan University	MOLECULAR VISION	Retinal whole genome microarray analysis and early morphological changes in the optic nerves of monkeys after an intraorbital nerve irradiated injury
zhang qingjiong	China:Sun Yat Sen Univ, State Key Lab Ophthalmol, Zhongshan Ophthalm Ctr, Guangzhou 510060, Guangdong,Peoples R China. Sun Yat Sen University	ARCHIVES OF OPHTHALMOLOGY	Novel SOX2 mutation associated with ocular coloboma in a Chinese family
zhang rui	China:Fudan Univ, Dept Ophthalmol, Eye & ENT Hosp, Shanghai 200433,Peoples R China. Fudan University	CURRENT EYE RESEARCH	Histopathology and Immunohistochemical Profile in Idiopathic Dacryoadenitis
zhang rui	China:Fudan Univ, Dept Ophthalmol, Eye & ENT Hosp, Shanghai 200433,Peoples R China. Fudan University	EUROPEAN JOURNAL OF OPHTHALMOLOGY	Multifocal visual evoked potentials in unilateral compressive optic neuropathy secondary to orbital tumors
zhang rui	China:Fudan Univ, Dept Ophthalmol, Eye & ENT Hosp, Shanghai 200433,Peoples R China. Fudan University	BRITISH JOURNAL OF OPHTHALMOLOGY	Treatment of orbital vascular malformations with intralesional injection of pingyangmycin
zhang shuying	China:Beijing Union Med Coll Hosp, Peking Union Med Coll, Dept Pathol, Beijing 100710,Peoples R China. Chinese Academy of Medical Sciences - Peking Union Medical College	EXPERIMENTAL EYE RESEARCH	Transthyretin Ala36Pro mutation in a Chinese pedigree of familial transthyretin amyloidosis with elevated vitreous and serum vascular endothelial growth factor
zhang simin	China:Peking Univ, Peoples Hosp, Dept Endocrinol & Metab, Beijing 100871,Peoples R China. Peking University	PLOS ONE	Age at Diagnosis and C-Peptide Level Are Associated with Diabetic Retinopathy in Chinese
zhang xiaojun	China:Capital Med Univ, Dept Neurol, Beijing Tongren Hosp, Beijing 100730,Peoples R China. Capital Medical University	ACTA OPHTHALMOLOGICA	Cerebrospinal fluid pressure in ocular hypertension
zhang xiaomin	China:Tianjin Med Univ, Hosp Eye, Coll Optometry, Inst Eye, Tianjin 300384,Peoples R China. Tianjin Medical University	GRAEFES ARCHIVE FOR CLINICAL AND EXPERIMENTAL OPHTHALMOLOGY	Reconstruction of orbital defects by implantation of antigen-free bovine cancellous bone scaffold combined with bone marrow mesenchymal stem cells in rats
zhang xuelin	China:So Med Univ, Nanfang Hosp, Dept Radiol, Guangzhou 510515, Guangdong,Peoples R China. Southern Medical University - China	INTERNATIONAL JOURNAL OF OPHTHALMOLOGY	Magnetic resonance diffusion tensor imaging and diffusion tensor tractography of human visual pathway
zhang yan	China:Sun Yat Sen Univ, State Key Lab Ophthalmol, Zhongshan Ophthalm Ctr, Guangzhou 510060, Guangdong,Peoples R China. Sun Yat Sen University	INTERNATIONAL JOURNAL OF OPHTHALMOLOGY	Magnetic resonance diffusion tensor imaging and diffusion tensor tractography of human visual pathway
zhang yipei	China:Tianjin Med Univ, Hosp 2, Gamma Knife Ctr, Dept Neurosurg, Tianjin 300211,Peoples R China. Tianjin Medical University	BRITISH JOURNAL OF OPHTHALMOLOGY	Gamma knife radiosurgery for primary orbital varices: a preliminary report
zhang zhiyuan	China:Tianjin Med Univ, Hosp 2, Gamma Knife Ctr, Dept Neurosurg, Tianjin 300211,Peoples R China. Tianjin Medical University	BRITISH JOURNAL OF OPHTHALMOLOGY	Gamma knife radiosurgery for primary orbital varices: a preliminary report
zhang zuyong	China:Nanjing Med Univ, Hangzhou Peoples Hosp 1, Dept Neurosurg, Hangzhou 310006, Zhejiang,Peoples R China. Nanjing Medical University	JOURNAL OF NEURO-OPHTHALMOLOGY	Ectopic Pituitary Adenoma in the Spheno-Orbital Region
zhao hua	China:Guangxi Med Univ, Dept Geriatr & Gerontol, Affiliated Hosp 1, Nanning,Peoples R China. Guangxi Medical University	PLOS ONE	Association between the IL1B (-511), IL1B (+3954), IL1RN (VNTR) Polymorphisms and Graves' Disease Risk: A Meta-Analysis of 11 Case-Control Studies
zhao jingjing	China:Tianjin Med Univ, Hosp Eye, Coll Optometry, Inst Eye, Tianjin 300384,Peoples R China. Tianjin Medical University	GRAEFES ARCHIVE FOR CLINICAL AND EXPERIMENTAL OPHTHALMOLOGY	Reconstruction of orbital defects by implantation of antigen-free bovine cancellous bone scaffold combined with bone marrow mesenchymal stem cells in rats
zhao kanxing	China:Tianjin Med Univ, Clin Coll Ophthalmol, Tianjin Eye Hosp, Tianjin,Peoples R China. Tianjin Medical University	JOURNAL OF AAPOS	Diagnosis and surgical treatment of unilateral restrictive hypotropia and esotropia
zhao liquan	China:Second Mil Med Univ, Shanghai Changzheng Hosp, Dept Ophthalmol, Shanghai 200003,Peoples R China. Second Military Medical University	INVESTIGATIVE OPHTHALMOLOGY & VISUAL SCIENCE	The Expression of Intercellular Adhesion Molecule-1 Induced by CD40-CD40L Ligand Signaling in Orbital Fibroblasts in Patients with Graves' Ophthalmopathy
zhao liquan	China:Shanghai Jiao Tong Univ, Sch Med, Xinhua Hosp, Dept Ophthalmol, Shanghai 200092,Peoples R China. Shanghai Jiao Tong University	OPHTHALMOLOGY	Topical Anesthesia versus Regional Anesthesia for Cataract Surgery: A Meta-Analysis of Randomized Controlled Trials
zhao peiquan	China:Shanghai Jiao Tong Univ, Sch Med, Xinhua Hosp, Dept Ophthalmol, Shanghai 200092,Peoples R China. Shanghai Jiao Tong University	OPHTHALMOLOGY	Topical Anesthesia versus Regional Anesthesia for Cataract Surgery: A Meta-Analysis of Randomized Controlled Trials
zhao pengxiang	China:Beijing Univ Technol, Coll Life Sci & Bioengn, Beijing,Peoples R China. Beijing University of Technology	PLOS ONE	Quantification of Epstein-Barr Virus DNA in Patients with Idiopathic Orbital Inflammatory Pseudotumor
zhao pingqian	China:Shanghai Jiao Tong Univ, Sch Med, Peoples Hosp 9, Dept Ophthalmol, Shanghai 200011,Peoples R China. Shanghai Jiao Tong University	EXPERIMENTAL EYE RESEARCH	Insulin-like growth factor 1 promotes the proliferation and adipogenesis of orbital adipose-derived stromal cells in thyroid-associated ophthalmopathy
zhao shuangxia	China:Shanghai Jiao Tong Univ, Ruijin Hosp, Sch Med, Dept Endocrinol,Shanghai Inst Endocrinol & Metab, Shanghai 200030,Peoples R China. Shanghai Jiao Tong University	PLOS ONE	A Refined Study of FCRL Genes from a Genome-Wide Association Study for Graves' Disease
zhao shuangxia	China:Shanghai Jiao Tong Univ, Ruijin Hosp, Sch Med, Dept Endocrinol,Shanghai Inst Endocrinol & Metab, Shanghai 200030,Peoples R China. Shanghai Jiao Tong University	PLOS ONE	Genetic Heterogeneity of Susceptibility Gene in Different Ethnic Populations: Refining Association Study of PTPN22 for Graves' Disease in a Chinese Han Population
zhao suyan	China:Peking Univ, Coll Med, Dept Ophthalmol, Beijing 100871,Peoples R China. Peking University	OPHTHALMIC PLASTIC AND RECONSTRUCTIVE SURGERY	Primary Orbital Pleomorphic Liposarcoma: An Aggressive Course
zhao yanyan	China:Cent S Univ, Inst Clin Pharmacol, Changsha 410083, Hunan,Peoples R China. Central South University	OCULAR IMMUNOLOGY AND INFLAMMATION	Granulomatosis with Polyangiitis: The Relationship Between Ocular and Nasal Disease
zhao yong	China:Chinese Peoples Liberat Army Gen Hosp, Dept Ophthalmol, Beijing 100853,Peoples R China. 	INTERNATIONAL JOURNAL OF OPHTHALMOLOGY	Comparative study of modified and conventional secondary hydroxyapatite orbital implantations
zheng yangbo	China:GuangZhou Med Univ, Key Lab Neurogenet & Channelopathies Guangdong Pr, Guangzhou, Guangdong,Peoples R China. Guangzhou Medical University	PLOS ONE	Serum Thyroid-Stimulating Hormone and Anti-Thyroglobulin Antibody Are Independently Associated with Lesions in Spinal Cord in Central Nervous System Demyelinating Diseases
zhong rugang	China:Beijing Univ Technol, Coll Life Sci & Bioengn, Beijing,Peoples R China. Beijing University of Technology	PLOS ONE	Quantification of Epstein-Barr Virus DNA in Patients with Idiopathic Orbital Inflammatory Pseudotumor
zhong xiaohuan	China:Cent S Univ, Xiangya Hosp, Dept Oral & Maxillofacial Surg, Changsha 410008, Hunan,Peoples R China. Central South University	OPHTHALMIC PLASTIC AND RECONSTRUCTIVE SURGERY	Investigation of Anthropometric Measurements of Anatomic Structures of Orbital Soft Tissue in 102 Young Han Chinese Adults
zhong yong	China:Chinese Acad Med Sci, Peking Union Med Coll Hosp, Dept Ophthalmol, Beijing 100730,Peoples R China. Chinese Academy of Medical Sciences - Peking Union Medical College	GRAEFES ARCHIVE FOR CLINICAL AND EXPERIMENTAL OPHTHALMOLOGY	Locally produced insulin-like growth factor-1 by orbital fibroblasts as implicative pathogenic factor rather than systemically circulated IGF-1 for patients with thyroid-associated ophthalmopathy
zhou huanjiao	China:Sun Yat Sen Univ, Zhongshan Ophthalm Ctr, State Key Lab Ophthalmol, Guangzhou 510060, Guangdong,Peoples R China. Sun Yat Sen University	MOLECULAR VISION	Retro-orbital injection of FITC-dextran is an effective and economical method for observing mouse retinal vessels
zhou huifang	China:Shanghai Jiao Tong Univ, Sch Med, Peoples Hosp 9, Dept Ophthalmol, Shanghai 200011,Peoples R China. Shanghai Jiao Tong University	EXPERIMENTAL EYE RESEARCH	Insulin-like growth factor 1 promotes the proliferation and adipogenesis of orbital adipose-derived stromal cells in thyroid-associated ophthalmopathy
zhou huifang	China:Shanghai Jiao Tong Univ, Sch Med, Peoples Hosp 9, Dept Ophthalmol, Shanghai 200011,Peoples R China. Shanghai Jiao Tong University	INVESTIGATIVE OPHTHALMOLOGY & VISUAL SCIENCE	In Vivo Efficacy of Bone Marrow Stromal Cells Coated with Beta-Tricalcium Phosphate for the Reconstruction of Orbital Defects in Canines
zhou qiong	China:Nanchang Univ, Dept Ophthalmol, Affiliated Hosp 1, Nanchang 330006, Jiangxi,Peoples R China. Nanchang University	INTERNATIONAL JOURNAL OF OPHTHALMOLOGY	Aerocyst urethral catheter insertion compared to expansion sponges application in external dacryocystorhinostomy
zhu huang	China:Shanghai Jiao Tong Univ, Sch Med, Xinhua Hosp, Dept Ophthalmol, Shanghai 200092,Peoples R China. Shanghai Jiao Tong University	OPHTHALMOLOGY	Topical Anesthesia versus Regional Anesthesia for Cataract Surgery: A Meta-Analysis of Randomized Controlled Trials
zhu zhenghong	China:Capital Med Univ, Dept Stomatol, Tongren Hosp, Beijing,Peoples R China. Capital Medical University	OPHTHALMIC PLASTIC AND RECONSTRUCTIVE SURGERY	Reconstruction of anophthalmic orbits and contracted eye sockets with microvascular radial forearm free flaps
zou xuan	China:Beijing Union Med Coll Hosp, Peking Union Med Coll, Dept Ophthalmol, Beijing 100710,Peoples R China. Chinese Academy of Medical Sciences - Peking Union Medical College	EXPERIMENTAL EYE RESEARCH	Transthyretin Ala36Pro mutation in a Chinese pedigree of familial transthyretin amyloidosis with elevated vitreous and serum vascular endothelial growth factor
