cai zhigang	China:Peking Univ Sch & Hosp Stomatol, Dept Oral & Maxillofacial Surg, Beijing 100081,Peoples R China. Peking University	BRITISH JOURNAL OF OPHTHALMOLOGY	Microvascular autologous transplantation of partial submandibular gland for severe keratoconjunctivitis sicca
chen hui	China:Sichuan Acad Med Sci, Dept Ophthalmol, Chengdu 610072, Sichuan Prov,Peoples R China. 	INTERNATIONAL JOURNAL OF OPHTHALMOLOGY	Comparison on conjunctival sac bacterial flora of the seniors with dry eye in Ganzi autonomous prefecture
chen zhiyuan	China:Peking Univ, Hosp Stomatol, Dept Oral & Maxillofacial Surg, Beijing 100081,Peoples R China. Peking University	CORNEA	Establishment of a Rabbit Model for Keratoconjunctivitis Sicca
chen zhiyuan	China:Peking Univ, Hosp Stomatol, Dept Oral & Maxillofacial Surg, Beijing 100081,Peoples R China. Peking University	INVESTIGATIVE OPHTHALMOLOGY & VISUAL SCIENCE	Treatment of Severe Keratoconjunctivitis Sicca by Parotid Duct Transposition after Tympanic Neurectomy in Rabbits
cheng x	China:Chinese PLA Med Sch, Dept Ophthalmol, Beijing,Peoples R China. 	EYE	Ophthalmic manifestations in a Chinese family with familial amyloid polyneuropathy due to a TTR Gly83Arg mutation
duo ji	China:Ganzi Autonomous Prefecture Peoples Hosp Sichuan, Dept Ophthalmol, Ganzi 626000, Sichuan Provinc,Peoples R China. 	INTERNATIONAL JOURNAL OF OPHTHALMOLOGY	Comparison on conjunctival sac bacterial flora of the seniors with dry eye in Ganzi autonomous prefecture
fan yingchuan	China:Sichuan Acad Med Sci, Dept Ophthalmol, Chengdu 610072, Sichuan Prov,Peoples R China. 	INTERNATIONAL JOURNAL OF OPHTHALMOLOGY	Comparison on conjunctival sac bacterial flora of the seniors with dry eye in Ganzi autonomous prefecture
gu changhong	China:Mudanjiang Med Coll, Mudanjiang,Peoples R China. 	OCULAR IMMUNOLOGY AND INFLAMMATION	Coal Dust Contiguity-induced Changes in the Concentration of TNF- and NF- B p65 on the Ocular Surface
hong jing	China:China Med Univ, Affiliated Hosp 1, Dept Ophthalmol, Shenyang 110001,Peoples R China. China Medical University	OCULAR IMMUNOLOGY AND INFLAMMATION	Coal Dust Contiguity-induced Changes in the Concentration of TNF- and NF- B p65 on the Ocular Surface
jiachu danba	China:Ganzi Autonomous Prefecture Peoples Hosp Sichuan, Dept Ophthalmol, Ganzi 626000, Sichuan Provinc,Peoples R China. 	INTERNATIONAL JOURNAL OF OPHTHALMOLOGY	Comparison on conjunctival sac bacterial flora of the seniors with dry eye in Ganzi autonomous prefecture
jie ying	China:Capital Med Univ, Beijing Tongren Hosp, Beijing Tongren Eye Ctr, Beijing,Peoples R China. Capital Medical University	INVESTIGATIVE OPHTHALMOLOGY & VISUAL SCIENCE	Treatment of Severe Keratoconjunctivitis Sicca by Parotid Duct Transposition after Tympanic Neurectomy in Rabbits
jin x	China:Chinese Peoples Liberat Army Gen Hosp, Dept Ophthalmol, Beijing 100853,Peoples R China. 	EYE	Ophthalmic manifestations in a Chinese family with familial amyloid polyneuropathy due to a TTR Gly83Arg mutation
jin xiudong	China:Mudanjiang Med Coll, Mudanjiang,Peoples R China. 	OCULAR IMMUNOLOGY AND INFLAMMATION	Coal Dust Contiguity-induced Changes in the Concentration of TNF- and NF- B p65 on the Ocular Surface
li j	China:Nankai Univ, Collage life Sci, Tianjin 300071,Peoples R China. Nankai University	EYE	Ophthalmic manifestations in a Chinese family with familial amyloid polyneuropathy due to a TTR Gly83Arg mutation
li yuchan	China:Fourth Peoples Hosp Zigong City, Zigong, Sichuan Provinc,Peoples R China. 	INTERNATIONAL JOURNAL OF OPHTHALMOLOGY	Comparison on conjunctival sac bacterial flora of the seniors with dry eye in Ganzi autonomous prefecture
liang qingfeng	China:Capital Univ Med Sci, Beijing Tongren Hosp, Inst Ophthalmol, Beijing,Peoples R China. Capital Medical University	CORNEA	Establishment of a Rabbit Model for Keratoconjunctivitis Sicca
liu t	China:Chinese Peoples Liberat Army Gen Hosp, Dept Ophthalmol, Hainan Branch, Sanya,Peoples R China. 	EYE	Ophthalmic manifestations in a Chinese family with familial amyloid polyneuropathy due to a TTR Gly83Arg mutation
liu xiaojing	China:Peking Univ Sch & Hosp Stomatol, Dept Oral & Maxillofacial Surg, Beijing 100081,Peoples R China. Peking University	BRITISH JOURNAL OF OPHTHALMOLOGY	Microvascular autologous transplantation of partial submandibular gland for severe keratoconjunctivitis sicca
liu zaiying	China:Mudanjiang Med Coll, Mudanjiang,Peoples R China. 	OCULAR IMMUNOLOGY AND INFLAMMATION	Coal Dust Contiguity-induced Changes in the Concentration of TNF- and NF- B p65 on the Ocular Surface
liu zhirong	China:Sichuan Acad Med Sci, Dept Ophthalmol, Chengdu 610072, Sichuan Prov,Peoples R China. 	INTERNATIONAL JOURNAL OF OPHTHALMOLOGY	Comparison on conjunctival sac bacterial flora of the seniors with dry eye in Ganzi autonomous prefecture
lv lan	China:Capital Univ Med Sci, Dept Ophthalmol, Affiliated Beijing Tong Ren Hosp, Beijing,Peoples R China. Capital Medical University	BRITISH JOURNAL OF OPHTHALMOLOGY	Microvascular autologous transplantation of partial submandibular gland for severe keratoconjunctivitis sicca
mao chi	China:Peking Univ Sch & Hosp Stomatol, Dept Oral & Maxillofacial Surg, Beijing 100081,Peoples R China. Peking University	BRITISH JOURNAL OF OPHTHALMOLOGY	Microvascular autologous transplantation of partial submandibular gland for severe keratoconjunctivitis sicca
peng xin	China:Peking Univ Sch & Hosp Stomatol, Dept Oral & Maxillofacial Surg, Beijing 100081,Peoples R China. Peking University	BRITISH JOURNAL OF OPHTHALMOLOGY	Microvascular autologous transplantation of partial submandibular gland for severe keratoconjunctivitis sicca
qin jian	China:Peking Univ Sch & Hosp Stomatol, Dept Oral & Maxillofacial Surg, Beijing 100081,Peoples R China. Peking University	BRITISH JOURNAL OF OPHTHALMOLOGY	Microvascular autologous transplantation of partial submandibular gland for severe keratoconjunctivitis sicca
su jiazeng	China:Peking Univ Sch & Hosp Stomatol, Dept Oral & Maxillofacial Surg, Beijing 100081,Peoples R China. Peking University	BRITISH JOURNAL OF OPHTHALMOLOGY	Microvascular autologous transplantation of partial submandibular gland for severe keratoconjunctivitis sicca
sun zhaoyi	China:China Med Univ, Affiliated Hosp 1, Dept Ophthalmol, Shenyang 110001,Peoples R China. China Medical University	OCULAR IMMUNOLOGY AND INFLAMMATION	Coal Dust Contiguity-induced Changes in the Concentration of TNF- and NF- B p65 on the Ocular Surface
wang guangjin	China:Luzhou Med Coll, Hosp TCM, Luzhou 646000, Sichuan Provinc,Peoples R China. 	INTERNATIONAL JOURNAL OF OPHTHALMOLOGY	Comparison on conjunctival sac bacterial flora of the seniors with dry eye in Ganzi autonomous prefecture
wang w	China:Chinese Peoples Liberat Army Gen Hosp, Hainan Branch, Dept Gastroenterol & Hepatol, Sanya,Peoples R China. 	EYE	Ophthalmic manifestations in a Chinese family with familial amyloid polyneuropathy due to a TTR Gly83Arg mutation
wu jun	China:Capital Univ Med Sci, Dept Ophthalmol, Affiliated Beijing Bo Ai Hosp, Beijing,Peoples R China. Capital Medical University	BRITISH JOURNAL OF OPHTHALMOLOGY	Microvascular autologous transplantation of partial submandibular gland for severe keratoconjunctivitis sicca
yu guangyan	China:Peking Univ, Hosp Stomatol, Dept Oral & Maxillofacial Surg, Beijing 100081,Peoples R China. Peking University	CORNEA	Establishment of a Rabbit Model for Keratoconjunctivitis Sicca
yu guangyan	China:Peking Univ, Hosp Stomatol, Dept Oral & Maxillofacial Surg, Beijing 100081,Peoples R China. Peking University	INVESTIGATIVE OPHTHALMOLOGY & VISUAL SCIENCE	Treatment of Severe Keratoconjunctivitis Sicca by Parotid Duct Transposition after Tympanic Neurectomy in Rabbits
yuan h	China:Chinese Peoples Liberat Army Gen Hosp, Inst Otolaryngol, Beijing 100853,Peoples R China. 	EYE	Ophthalmic manifestations in a Chinese family with familial amyloid polyneuropathy due to a TTR Gly83Arg mutation
zewang gema	China:Ganzi Autonomous Prefecture Peoples Hosp Sichuan, Dept Clin Lab, Ganzi 626000, Sichuan Provinc,Peoples R China. 	INTERNATIONAL JOURNAL OF OPHTHALMOLOGY	Comparison on conjunctival sac bacterial flora of the seniors with dry eye in Ganzi autonomous prefecture
zhang b	China:Chinese PLA Med Sch, Dept Ophthalmol, Beijing,Peoples R China. 	EYE	Ophthalmic manifestations in a Chinese family with familial amyloid polyneuropathy due to a TTR Gly83Arg mutation
zhang lei	China:Peking Univ Sch & Hosp Stomatol, Dept Oral & Maxillofacial Surg, Beijing 100081,Peoples R China. Peking University	BRITISH JOURNAL OF OPHTHALMOLOGY	Microvascular autologous transplantation of partial submandibular gland for severe keratoconjunctivitis sicca
zhang yue	China:Sichuan Acad Med Sci, Dept Ophthalmol, Chengdu 610072, Sichuan Prov,Peoples R China. 	INTERNATIONAL JOURNAL OF OPHTHALMOLOGY	Comparison on conjunctival sac bacterial flora of the seniors with dry eye in Ganzi autonomous prefecture
zheng hong	China:Ganzi Autonomous Prefecture Peoples Hosp Sichuan, Dept Ophthalmol, Ganzi 626000, Sichuan Provinc,Peoples R China. 	INTERNATIONAL JOURNAL OF OPHTHALMOLOGY	Comparison on conjunctival sac bacterial flora of the seniors with dry eye in Ganzi autonomous prefecture
zou liuhe	China:Capital Univ Med Sci, Dept Ophthalmol, Affiliated Beijing Tong Ren Hosp, Beijing,Peoples R China. Capital Medical University	BRITISH JOURNAL OF OPHTHALMOLOGY	Microvascular autologous transplantation of partial submandibular gland for severe keratoconjunctivitis sicca
