D Droutsas	希腊雅典大学雅典总医院眼科	国际眼科杂志	眼睑阴虱1例报告及图片样本
E Malamou-Lada	希腊雅典大学雅典总医院微生物学实验室	国际眼科杂志	眼睑阴虱1例报告及图片样本
Hervé Robin	法国巴黎国立BICHAT大学医院中心	中华实验眼科杂志	应用免疫荧光技术对眼瘢痕性类天疱疮的研究
Ifeoma Regina Ezegwui	尼日利亚埃努古州科技大学教学医院眼科	国际眼科杂志	尼日利亚埃努古春季结膜炎的临床特征
Jian-Hui Xiao	中山大学附属第二医院眼科	国际眼科杂志	逆行镊撕法联合3种手术方式预防翼状胬肉复发的疗效分析
K Droutsas	希腊雅典大学雅典总医院眼科	国际眼科杂志	眼睑阴虱1例报告及图片样本
K Tzanetou	希腊雅典大学雅典总医院微生物学实验室	国际眼科杂志	眼睑阴虱1例报告及图片样本
M Kafentzi	希腊雅典大学雅典总医院微生物学实验室	国际眼科杂志	眼睑阴虱1例报告及图片样本
Mat Saad Noram	马来亚大学医学院眼科	国际眼科杂志	单侧翼状胬肉患者50例泪液功能的改变
May May Choo	马来亚大学医学院眼科	国际眼科杂志	单侧翼状胬肉患者50例泪液功能的改变
Sagili Chandrasekhara Reddy	马来亚大学医学院眼科	国际眼科杂志	单侧翼状胬肉患者50例泪液功能的改变
Sunita P Nair	马来亚大学医学院眼科	国际眼科杂志	单侧翼状胬肉患者50例泪液功能的改变
Thanh Hoang-xuan	法国巴黎国立BICHAT大学医院中心	中华实验眼科杂志	应用免疫荧光技术对眼瘢痕性类天疱疮的研究
Yu-Qing Lan	中山大学附属第二医院眼科	国际眼科杂志	逆行镊撕法联合3种手术方式预防翼状胬肉复发的疗效分析
Yu-Xin Hu	中山大学附属第二医院眼科	国际眼科杂志	逆行镊撕法联合3种手术方式预防翼状胬肉复发的疗效分析
丁侃	上海第二医科大学附属瑞金医院眼科	中华眼科杂志	翼状胬肉中碱性成纤维细胞生长因子的表达及其与肥大细胞的关系
丁功奎	吉首市人民医院	眼外伤职业眼病杂志	自体角膜缘干细胞移植治疗翼状胬肉378例
丁国强	复旦大学附属眼耳鼻喉科医院耳鼻喉科	中国眼耳鼻喉科杂志	不同螨致敏原对变应性鼻炎患者生活质量的影响
丁娟	天津医科大学	中国中医眼科杂志	睑角结膜炎病例临床表现及疗效分析
丁慰祖	上海交通大学附属第六人民医院眼科	中华实验眼科杂志	翼状胬肉胶原变化的研究
丁文盛	武汉市第七医院眼科	中国实用眼科杂志	新鲜羊膜移植治疗翼状胬肉48例临床观察
丁正平	华中科技大学同济医学院附属协和医院眼科	眼科	基质金属蛋白酶、凋亡、端粒酶与翼状胬肉
丁正平	华中科技大学同济医学院附属协和医院眼科	中华实验眼科杂志	染料木黄酮对翼状胬肉成纤维细胞增殖的抑制作用
丁玉珠	山东省莘县眼科医院	中华眼视光学与视觉科学杂志	结膜囊吸吮线虫病五例
丁琳	新疆维吾尔自治区人民医院眼科	眼科	先天性眼皮肤黑变病继发青光眼一例
丁瑞国	山东省寿光市人民医院	眼外伤职业眼病杂志	角膜缘上皮双向转移联合丝裂霉素C治疗翼状胬肉
丁艳	安徽省蒙城县第二人民医院	临床眼科杂志	翼状胬肉切除联合自体角膜缘干细胞移植手术的临床观察
丁莲娥	安徽海螺集团公司总医院眼科宁国	中华实验眼科杂志	人羊膜联合自体角膜缘移植治疗复发性翼状胬肉
丁萍	江苏省常州市第一人民医院眼科	临床眼科杂志	角膜塑形术并发症的临床分析
丁蕾	山东大学山东省立医院眼科	国际眼科杂志	沙眼防治的研究进展
丁韧	上海市烧伤研究所	中华实验眼科杂志	翼状胬肉胶原变化的研究
万修华	北京同仁医院眼科	中国实用眼科杂志	过敏性结膜炎的临床特点
万安云	中国人民武装警察部队江西总队医院眼科中心	中华眼科杂志	外伤致巩膜层间漏一例
万小波	广西医科大学第一附属医院眼科中心	中国实用眼科杂志	翼状胬肉术后诊断为血友病A一例
万水英	新晃县人民医院眼科	中国实用眼科杂志	角膜缘干细胞移植和羊膜移植术治疗复发性翼状胬肉临床疗效比较
万金兰	华中科技大学同济医学院附属协和医院眼科	中华眼视光学与视觉科学杂志	抑肽酶对翼状胬肉成纤维细胞肿瘤坏死因子-α的抑制作用
万鹏霞	广州市花都区人民医院眼科	临床眼科杂志	翼状胬肉切除术后应用贝复舒与爱丽滴眼液疗效对比观察
丘武新	广东省梅县人民医院五官科	中华眼科杂志	广东省梅县盲和低视力流行病学调查
丛日昌	中国广东省深圳市西乡人民医院眼科	国际眼科杂志	裂隙灯眼前段处理系统在眼科的临床应用
严京	中国中医科学院眼科医院	中国中医眼科杂志	川椒方治疗过敏性结膜炎的临床观察
严兰凤	甘肃省人民医院	眼外伤职业眼病杂志	表皮生长因子在翼状胬肉术后的应用观察
严吕霞	中国湖北省仙桃市第一人民医院眼科	国际眼科杂志	手术放大镜下行翼状胬肉切除联合自体角膜缘干细胞移植术临床分析
严宗辉	深圳市眼科医院，深圳	眼科	翼状胬肉与角膜散光之间关系的研究
严锦云	中国湖北省仙桃市第一人民医院眼科	国际眼科杂志	手术放大镜下行翼状胬肉切除联合自体角膜缘干细胞移植术临床分析
乐琦骅	复旦大学附属眼耳鼻喉科医院	中国实用眼科杂志	双氯芬酸钠透明质酸钠滴眼液治疗急性变态反应性结膜炎评价
乐琦骅	复旦大学附属眼耳鼻喉科医院眼科	中华眼科杂志	激光共聚焦显微镜观察春季角结膜炎患者的角膜形态变化
乐琦骅	复旦大学附属眼耳鼻喉科医院	中华眼视光学与视觉科学杂志	0.1%普拉洛芬滴眼液治疗急性变态反应性结膜炎的疗效
乔宝笛	温州医学院附属第二医院眼科	临床眼科杂志	翼状胬肉术后的角膜地形图改变
乔彤	华中科技大学同济医学院附属协和医院眼科	国际眼科杂志	儿童过敏性结膜炎诊治进展
乔彤	华中科技大学同济医学院附属协和医院眼科	临床眼科杂志	儿童过敏性结膜炎和过敏性鼻炎的关系
乔彤	华中科技大学附属协和医院	中华眼视光学与视觉科学杂志	儿童过敏性结膜炎与变应性疾病的相关性
乔志燕	承德医学院附属医院眼科	中国斜视与小儿眼科杂志	42例新生儿淋菌性结膜炎治疗
于世辉	河南省濮阳市眼科医院	中国中医眼科杂志	自体角膜缘球结膜移植治疗翼状胬肉疗效观察
于亚东	河南大学淮河医院	眼外伤职业眼病杂志	翼状胬肉三种手术方法的临床效果观察
于伟鸿	中国协和医科大学	中国实用眼科杂志	倒睫激光疗效106例观察
于健	河北省保定市第一中心医院眼科	临床眼科杂志	羊膜移植在复发性翼状胬肉手术中的应用
于刚	首都医科大学附属北京儿童医院眼科	中华实验眼科杂志	先天性阔睑一例
于刚	首都医科大学附属北京儿童医院眼科	中国斜视与小儿眼科杂志	Ritleng 泪道插管术治疗结膜炎导致的儿童继发性泪道阻塞疗效观察
于大仆	辽宁省抚顺市眼病医院	临床眼科杂志	巩膜暴露区板层角膜移植治疗复发性翼状胬肉
于大仆	中国辽宁省抚顺市眼病医院	国际眼科杂志	自体干细胞移植联合丝裂霉素C治疗翼状胬肉的临床观察
于婉荣	中国陕西省宝鸡市中医医院眼科	国际眼科杂志	翼状胬肉病因和治疗与复发干预的临床研究进展
于小秋	广东省东莞市樟木头医院眼科	临床眼科杂志	应用角膜缘移植治疗复发性翼状胬肉疗效分析
于建国	天津宝坻县医院眼科	眼外伤职业眼病杂志	羊膜移植治疗复发性翼状胬肉
于时英	威海市文登中心医院眼科	眼外伤职业眼病杂志	药物合并剥离切除法治疗翼状胬肉的临床观察
于晓秋	广东省东莞市樟木头镇人民医院	临床眼科杂志	头孢曲松治疗新生儿淋菌性结膜炎46例
于林	辽宁抚顺眼病医院	中国实用眼科杂志	冻干人羊膜治疗翼状胬肉的临床观察
于焱	南京医科大学第一附属医院眼科	临床眼科杂志	羊膜移植在眼表疾病中的应用观察
于爱华	武汉大学中南医院眼科	国际眼科杂志	羊膜移植联合丝裂霉素C治疗翼状胬肉的Meta分析
于爱迪	山东省文登整骨医院眼科	眼外伤职业眼病杂志	药物合并剥离切除法治疗翼状胬肉的临床观察
于珍	辽宁省抚顺市眼病医院	临床眼科杂志	巩膜暴露区板层角膜移植治疗复发性翼状胬肉
于珍	中国辽宁省抚顺市眼病医院	国际眼科杂志	自体干细胞移植联合丝裂霉素C治疗翼状胬肉的临床观察
于莉	暨南大学附属深圳市眼科医院	中国实用眼科杂志	新生儿急性细菌性结膜炎10年致病菌变迁
于长旭	中国辽宁省辽阳市第三人民医院眼科	国际眼科杂志	自体角膜缘干细胞移植术治疗原发性翼状胬肉94例
于静	华中科技大学同济医学院附属协和医院眼科	中华眼视光学与视觉科学杂志	丁酸钠对翼状胬肉成纤维细胞增殖的抑制作用
于韬	辽宁省肿瘤医院医学影像科	国际眼科杂志	层黏连蛋白对人翼状胬肉成纤维细胞生长的抑制作用
付万科	大连旅顺口区人民医院眼科	中国实用眼科杂志	后巩膜炎误诊二例
付丽娟	河源市东源光明眼科医院	眼外伤职业眼病杂志	改良胬肉切除法加自体角膜缘干细胞移植
付亚平	镇平县公疗医院	眼外伤职业眼病杂志	平阳霉素治疗翼状胬肉的疗效观察
付亚林	中国陕西省宝鸡市中医医院眼科	国际眼科杂志	翼状胬肉病因和治疗与复发干预的临床研究进展
付佳玉	云南省思茅地区中医院眼科	中国中医眼科杂志	真菌性结膜炎误诊3例
付佳玉	思茅地区中医院眼科	中国中医眼科杂志	淋病性结膜炎误诊1例
付士新	中國河北省邢臺市眼科醫院跟科	国际眼科杂志	中西醫結合治瘵特异性幹眼癥
付少山	河南省信阳市中心医院眼科	中华实验眼科杂志	沙眼性角膜瘢痕合并老年性白内障人工晶状体植入32例手术体会
付智勇	首都医科大学附属北京友谊医院	眼外伤职业眼病杂志	自体角膜缘移植联合球结膜移植治疗翼状胬肉
付永姝	中国河北省邯郸市眼科医院	国际眼科杂志	翼状胬肉发病机制及治疗研究进展
付海涛	山东省临沂市人民医院博爱眼科	中国实用眼科杂志	表面麻醉在胬肉切除联合自体角膜缘干细胞移植术中的效果观察
付清	第二军医大学附属长海医院眼科	国际眼科杂志	转化生长因子β及其受体在翼状胬肉中基因表达的定量检测
付湘媛	中国人民解放军第五三五医院	眼科	自体角膜缘干细胞移植与羊膜移植治疗翼状胬肉的对比研究
付玉琦	山东省聊城国际和平医院眼科	中国眼耳鼻喉科杂志	结膜吸吮线虫1例
付玉芳	河北工业大学医院眼科，天津	眼科	配戴软性角膜接触镜者滤泡性结膜炎的诊治
付瑶	上海交通大学附属第九人民医院眼科	临床眼科杂志	改良角膜缘干细胞移植术治疗翼状胬肉的临床观察
付芳	陕西省咸阳市第一人民医院眼科	中国实用眼科杂志	自体角膜缘干细胞移植联合丝裂霉素治疗复发性翼状胬肉33例分析
付芳	中国陕西省咸阳市第一人民医院眼二科	国际眼科杂志	自体角膜缘干细胞移植联合丝裂霉素治疗翼状胬肉的临床效果
付莉萍	南阳市中心医院	眼外伤职业眼病杂志	手术切除联合羊膜移植治疗复发性翼状胬肉
付蓉花	郑州人民医院眼科	眼外伤职业眼病杂志	液氮冷冻治疗早期复发性翼状胬肉临床观察
付铁	天津市第四中心医院眼科	中国实用眼科杂志	自体角膜上皮移植治疗翼状胬肉
仝春梅	解放军白求恩国际和平医院眼科	中华实验眼科杂志	睫毛刺入致结膜囊肿一例
代海燕	牡丹江医学院红旗医院眼病中心	眼外伤职业眼病杂志	翼状胬肉术后角膜穿孔一例
代莉伟	黔东南州人民医院	眼外伤职业眼病杂志	羊膜移植重建眼表在基层医院的应用
仲彦霖	辽宁省辽阳市第201医院五官科	临床眼科杂志	翼状胬肉手术切除与冷冻治疗的疗效对比观察
仲明	第二军医大学附属长海医院眼科	国际眼科杂志	转化生长因子β及其受体在翼状胬肉中基因表达的定量检测
任亚琳	中国广东省深圳市第六人民医院眼科	国际眼科杂志	环孢霉素A在防止翼状胬肉复发中的作用
任小军	厦门眼科中心	中国斜视与小儿眼科杂志	厦门市思明区3～6岁儿童眼病调查
任岩海	牡丹江医学院附属红旗医院眼科	国际眼科杂志	复发性翼状胬肉切除联合角膜缘干细胞移植术或羊膜移植术的疗效比较
任延军	河北邯郸市眼科医院眼科	中国实用眼科杂志	翼状胬肉切除联合准分子激光治疗性角膜切削术与角膜缘干细胞移植术疗效对比观察
任延军	邯郸眼科医院眼科	国际眼科杂志	应用准分子激光角膜切削术治疗翼状胬肉的临床观察
任延君	中国河北省邯郸市眼科医院	国际眼科杂志	翼状胬肉手术治疗研究进展
任建利	中国陕西省商洛市中心医院眼科	国际眼科杂志	苏丹喀土穆地区春季卡他性角结膜炎720例临床分析
任建萍	上海中医药大学附属曙光医院	中国中医眼科杂志	翼状胬肉割烙术和胬肉切除联合羊膜移植术的疗效比较
任慧媛	河北省保定市第二医院眼科	中华实验眼科杂志	术中应用丝裂霉素C治疗翼状胬肉实验和临床研究
任敏子	陕西省汉中市人民医院眼科	眼外伤职业眼病杂志	自体角膜缘上皮移植治疗翼状胬肉
任新军	天津医科大学眼科中心	国际眼科杂志	云南省怒江州贡山县翼状胬肉的流行病学调查
任明玉	河北邢台医专第二附属医院眼科	眼外伤职业眼病杂志	结膜吸吮线虫病一例
任晓冬	张家口市第四医院眼科	眼科	带蒂结膜瓣转移法治疗翼状胬肉疗效观察
任桂杰	山东大学医学院	中国中医眼科杂志	角膜缘干细胞移植治疗复发性翼状胬肉的临床观察
任桂芳	济南市第四人民医院眼科	中国中医眼科杂志	角膜缘干细胞移植治疗复发性翼状胬肉的临床观察
任梅	中国陕西省西安市第四医院眼科	国际眼科杂志	医用生物蛋白胶在翼状胬肉切除联合角膜缘干细胞移植术中的应用
任百超	西安交通大学医学院第二附属医院眼科	国际眼科杂志	带蒂结膜瓣转移联合丝裂霉素C治疗复发性翼状胬肉的临床研究
任红	辽宁省人民医院眼科	国际眼科杂志	翼状胬肉切除联合自体角膜缘干细胞移植术疗效分析
伍俊	永州市眼科研究所	眼外伤职业眼病杂志	翼状胬肉术后滴用重组人表皮生长因子的疗效
伍凯强	中国江苏省昆山市第一人民医院	国际眼科杂志	VEGF、CD34、Ki-67和p21在翼状胬肉中的表达及意义
伍尚贤	广东省新兴县人民医院眼科	临床眼科杂志	翼状胬肉切除联合透明角膜切口白内障超声乳化吸除人工晶状体植入术的临床观察
伍志琴	武汉大学人民医院眼科武汉大学医学院眼科研究所	中国实用眼科杂志	异体巩膜联合多层羊膜移植治疗翼状胬肉术后无菌性角巩膜融解的疗效探讨
伍玉冰	中山市小榄人民医院眼科	中国中医眼科杂志	自体角膜缘干细胞移植联合丝裂霉素C治疗翼状胬肉的临床研究
伍继光	喀什农三师医院眼科	眼外伤职业眼病杂志	自体角膜缘干细胞移植治疗翼状胬肉148例
但汉东	武汉大学第一临床医学院	国际眼科杂志	自体角膜缘干细胞移植联合MMC对翼状胬肉疗效的Meta分析
何为民	四川大学华西医院眼科	国际眼科杂志	明胶酶MMP-2和MMP-9及其组织抑制剂与眼科疾病
何为民	四川大学华西医院眼科	中国实用眼科杂志	双眼Stevens-Johnson综合征误诊1例
何亚妮	云南省大理白族自治州人民医院眼科	临床眼科杂志	翼状胬肉与角膜散光的关系初步报告
何亚妮	云南省大理州人民医院眼科	眼外伤职业眼病杂志	眼外伤及眼表疾病自体角膜缘干细胞移植术
何伟	沈阳何氏眼科医院	中国实用眼科杂志	纤维蛋白胶在翼状胬肉切除联合无缝线羊膜移植术中应用的临床观察
何伟杰	中国人民解放军第一八○医院眼科	国际眼科杂志	滑行移植自体角膜缘干细胞联合丝裂霉素C治疗翼状胬肉
何偉	中國沈陽何氏眼科醫院，	国际眼科杂志	帶蒂球結膜與角膜緣上皮移植治療翼狀胬肉
何健强	广东省台山市人民医院眼科	临床眼科杂志	冷冻保存羊膜移植治疗眼表疾病疗效观察
何向蕾	宁波李惠利医院病理科	眼科	翼状胬肉复发与组织病理学的关系
何太雯	上海市吴泾医院眼科	临床眼科杂志	自体角膜缘干细胞移植联合羊膜移植治疗复发性翼状胬肉
何守志	解放军总医院眼科	中华眼科杂志	21世纪白内障复明工作面临挑战
何宏辉	广西自治区灵山县人民医院眼科	临床眼科杂志	巨大翼状胬肉遮盖眼球1例
何慧琴	南京市中医院眼科	临床眼科杂志	三种术式治疗翼状胬肉疗效观察
何洁华	广东省职业病防治院	眼外伤职业眼病杂志	视屏终端作业对视疲劳影响的调查
何淑梅	中国广东省大埔县人民医院眼科	国际眼科杂志	角膜缘干细胞联合羊膜移植治疗翼状胬肉疗效观察
何湘珍	南华大学第二附属医院	中国中医眼科杂志	保存羊膜及丝裂霉素对翼状胬肉眼表的影响
何碧华	广西中医药大学附属瑞康医院眼科	临床眼科杂志	准分子激光治疗早期复发性翼状胬肉的临床观察
何碧华	广西中医学院附属瑞康医院眼科	国际眼科杂志	角膜塑形镜治疗青少年近视的临床观察
何秀梅	广州军区武汉总医院眼科	国际眼科杂志	二期羟基磷灰石义眼台早期植入临床观察
何素华	唐山市协和医院眼科	临床眼科杂志	春季卡他性结膜炎78例临床分析
何艳云	暨南大学医学院附属第二医院	中国实用眼科杂志	新鲜羊膜移植治疗翼状胬肉的临床观察
何艳花	暨南大学附属第一医院眼科	中华实验眼科杂志	丝裂霉素C对翼状胬肉成纤维细胞膜通透性及超微结构的影响
何苗	绵阳万江眼科医院	眼外伤职业眼病杂志	羊膜移植治疗翼状胬肉137例
何锦贤	佛山市第一人民医院眼科	眼科	人羊膜移植治疗翼状胬肉等眼表疾病的临床观察
何雅微	广东省新兴县人民医院眼科	临床眼科杂志	翼状胬肉切除联合透明角膜切口白内障超声乳化吸除人工晶状体植入术的临床观察
佘华宁	西安交通大学医学院第二附属医院眼科	国际眼科杂志	带蒂结膜瓣转移联合丝裂霉素C治疗复发性翼状胬肉的临床研究
佘惜金	广东省职业病防治院	眼外伤职业眼病杂志	视屏终端作业对视疲劳影响的调查
余业明	钦州市第二人民医院	眼外伤职业眼病杂志	羊膜移植治疗难治性眼表疾病的临床效果
余健儿	广东省汕尾逸挥基金医院眼科	中国实用眼科杂志	翼状胬肉不同手术方法疗效分析
余国健	广东省台山市人民医院眼科	临床眼科杂志	冷冻保存羊膜移植治疗眼表疾病疗效观察
余小妹	宁波市江东眼科医院	临床眼科杂志	金霉素眼膏涂眼致药物毒性角膜上皮炎2例
余小青	四川省隆昌县人民医院眼科	中国眼耳鼻喉科杂志	自体角膜缘干细胞移植治疗翼状胬肉
余志洪	韶关市第一人民医院	眼外伤职业眼病杂志	羊膜联合自体角膜缘干细胞移植治疗翼状胬肉
余志洪	广东省韶关市第一人民医院眼科	临床眼科杂志	新鲜羊膜移植治疗复发性翼状胬肉
余惠芳	中国人民解放军第四二一医院眼科	国际眼科杂志	术中应用丝裂霉素治疗不同类型原发性翼状胬肉的疗效观察
余惠芳	中国人民解放军第四二一医院眼科	国际眼科杂志	生物羊膜移植联合丝裂霉素和血管抑素治疗复发性翼状胬肉
余惠芳	中国人民解放军第421医院眼科	国际眼科杂志	头孢曲松钠治疗新生儿淋球菌性结膜炎
余桂国	中国湖北省武汉市第十一医院眼科	国际眼科杂志	新鲜羊膜联合自体角膜缘移植治疗复发性翼状胬肉的疗效分析
余正星	重庆钢铁公司总医院	中华眼视光学与视觉科学杂志	自体球结膜角巩膜瓣移植治疗复发性翼状胬肉
余江雁	云南省大理州医院眼科	眼外伤职业眼病杂志	羊膜移植术治疗翼状胬肉临床分析
余素英	绵阳万江眼科医院眼科	国际眼科杂志	带蒂结膜瓣移植联合MMC治疗翼状胬肉合并结膜松弛症
余红	中国云南省南华县人民医院眼科	国际眼科杂志	自血治疗春季角结膜炎106例
余芬芬	九江医学高等专科学校附属医院	眼外伤职业眼病杂志	翼状胬肉切除术后出血一例
余芬芬	中山大学中山眼科中心眼科学国家重点实验室	中华眼科杂志	透明质酸钠对兔含苯扎氯铵溴莫尼定眼表毒性保护作用的研究
余金龍	，中國新疆獨山子石化總廠醫院眼科	国际眼科杂志	自體角膜緣幹細胞球結膜移植治療翼狀胬肉
余金龙	新疆独山子石化总厂职工医院眼科	临床眼科杂志	阿斯匹林引起Stevens-Johnson综合征1例
余钦其	永州职业技术学院附属医院眼科	国际眼科杂志	改良式角膜缘干细胞移位术治疗早期翼状胬肉的临床研究
余锦强	郧阳医学院附属人民医院眼科	国际眼科杂志	逆行撕离联合原位自体结膜瓣旋转移植治疗翼状胬肉64例
佟锦	新疆克拉玛依市第二人民医院眼科	临床眼科杂志	慢性睑缘炎患者泪膜功能的临床分析
佳晓涵	辽宁抚顺眼病医院	中国实用眼科杂志	冻干人羊膜治疗翼状胬肉的临床观察
侍丛祥	河北省秦皇岛市	眼外伤职业眼病杂志	翼状胬肉逆行切除合并丝裂霉素应用预防复发观察
侯光辉	暨南大学医学院三附院	眼外伤职业眼病杂志	自体角膜缘上皮移植术治疗翼状胬肉的临床报告
侯承花	山东威海市文登中心医院	中国实用眼科杂志	结核性眼炎误诊为眼内肿瘤一例
侯景辉	中山大学肿瘤防治中心	中华眼科杂志	翼状胬肉上皮细胞p53蛋白的表达及其功能状态的研究
侯爱军	山东省菏泽第一中学医务室	中华实验眼科杂志	3365名中学生沙眼患病分析
侯立杰	温州医学院附属眼视光医院	国际眼科杂志	以复视为首发症状的非斜视性复视的病因分析
侯艳丽	首都医科大学附属北京友谊医院眼科	临床眼科杂志	眼部带状疱疹侵犯颅神经1例
俞丹洋	解放军59中心医院眼科	临床眼科杂志	四头带加压致角膜后弹力层断裂2例
俞丽云	大理州医院	眼外伤职业眼病杂志	羊膜移植联合丝裂霉素C防止翼状胬肉术后复发
俞兴元	北京中医药大学附属东直门医院眼科	中国中医眼科杂志	退赤止痒液治疗春季结膜炎
俞嘉怡	上海市第六人民医院	眼外伤职业眼病杂志	角膜缘干细胞移植治疗复发性翼状胬肉
俞存	宁波市第二医院眼病中心	中国中医眼科杂志	翼状胬肉切除联合改良滑行结膜瓣移植术的疗效观察
俞建雄	中山大学附属三院肝胆外科	国际眼科杂志	维生素E琥珀酸酯抑制人翼状胬肉成纤维细胞生长作用的研究
俞志华	兰州市第一人民医院	中国中医眼科杂志	针灸治疗目劄
俞晓艺	武钢第二职工医院眼科	眼外伤职业眼病杂志	5-氟尿嘧啶及丝裂霉素C在翼状胬肉术中的应用
俞素勤	上海交通大学附属第一人民医院眼科	中华实验眼科杂志	视网膜脱离术后植入物外露致低眼压一例
俞莹	上海中医药大学附属曙光医院	中国中医眼科杂志	翼状胬肉割烙术和胬肉切除联合羊膜移植术的疗效比较
倪云	江苏省中医院眼科中心	临床眼科杂志	不同激素浓度对预防翼状胬肉术后复发的临床观察
倪宁华	中国云南省第一人民医院眼科	国际眼科杂志	广泛切除联合术后丝裂霉素C滴眼治疗翼状胬肉
倪建新	温州医学院附属眼视光医院	中华眼视光学与视觉科学杂志	眼眶副节瘤1例
倪颖勤	复旦大学附属眼耳鼻喉科医院	眼外伤职业眼病杂志	结膜乳头切除加丝裂霉素C治疗春季角结膜炎
党锐	河南南阳医专附院	眼外伤职业眼病杂志	新鲜羊膜移植治疗翼状胬肉的临床观察
公重麟	中国湖北省襄樊市中心医院眼科	国际眼科杂志	高频电灼浚通术治疗泪道阻塞的疗效观察
关云凤	中国陕西省潼关县人民医院眼科	国际眼科杂志	复发性翼状胬肉切除联合干细胞移植及丝裂霉素C疗效观察
关云峰	克拉玛依市中心医院眼科	中国实用眼科杂志	准分子激光角膜上皮瓣下磨镶术治疗角膜浅层病变观察
关明	中国浙江省金华市中心医院眼科	国际眼科杂志	翼状胬肉组织PEDF和VEGF的不平衡表达
关明	上海市华山医院检验科	中华实验眼科杂志	PEDF和VEGF在翼状胬肉组织中的不平衡表达
关航	北京医院眼科	中华眼视光学与视觉科学杂志	我国开展角膜塑型术的现状及问题
具尔提	新疆医科大学第一附属医院眼科	中国实用眼科杂志	准分子激光角膜上皮瓣下磨镶术治疗角膜浅层病变观察
冀建平	广州中医药大学第一附属医院眼科	临床眼科杂志	FK506在实验性过敏性结膜炎局部免疫调控的作用
冉多军	新疆生产建设兵团农六师奇台医院眼科	国际眼科杂志	高海拔地区少数民族翼状胬肉治疗的临床观察
冉红军	利川市民族中医院	眼外伤职业眼病杂志	翼状胬肉撕脱术治疗翼状胬肉
冯一中	苏州大学附属一院眼科	国际眼科杂志	MMP-8在翼状胬肉中的表达
冯一中	苏州大学医学院病理科	中国实用眼科杂志	MMP-3、MMP-8在翼状胬肉中的表达
冯一帆	复旦大学附属中山医院眼科	中华实验眼科杂志	环孢素A在防止翼状胬肉术后复发中作用的meta分析
冯丽	河北省保定市第一中心医院眼科	临床眼科杂志	羊膜移植在复发性翼状胬肉手术中的应用
冯乃澎	建湖县人民医院眼科	中国中医眼科杂志	结膜瓣转位移植联合干扰素治疗翼状胬肉
冯先余	安徽省庐江县人民医院眼科	临床眼科杂志	单剂量丝裂霉素C局部注射对翼状胬肉组织中血管和成纤维细胞的影响
冯其高	深圳市眼科医院	临床眼科杂志	干眼对白内障手术的影响及其治疗方法
冯劼	中国湖北省武汉市第一医院眼科	国际眼科杂志	Toric人工晶状体植入矫正特殊角膜散光的疗效观察
冯延琴	延安大学附属医院眼科	国际眼科杂志	双氯芬酸钠滴眼液在翼状胬肉术后的应用
冯延琴	陕西省延安大学附属医院眼科	中国眼耳鼻喉科杂志	翼状胬肉切除术后联合贝复舒应用的疗效观察
冯强	天津医科大学	中国中医眼科杂志	睑角结膜炎病例临床表现及疗效分析
冯敏	湖北医药学院附属太和医院眼科	国际眼科杂志	新型硅胶泪道引流管在治疗泪道阻塞中的应用
冯文	广州医学院羊城医院眼科	临床眼科杂志	翼状胬肉显微手术切除后辅用曲安奈德的疗效观察
冯督	河南省濮阳市眼科医院	中国中医眼科杂志	自体角膜缘球结膜移植治疗翼状胬肉疗效观察
冯金玲	天津眼科医院	中国中医眼科杂志	睑角结膜炎病例临床表现及疗效分析
冯金玲	天津市眼科医院	中国中医眼科杂志	针刺对Sjogren综合征患者泪液的影响
冯金玲	天津眼科医院	中国中医眼科杂志	眼酒糟鼻57例临床观察
冯雅莉	中国山东省青岛市经济技术开发区第一人民医院眼科	国际眼科杂志	翼状胬肉术后角膜融解2例临床分析
凌懿	舟山市人民医院	眼外伤职业眼病杂志	翼状胬肉切除自体带结膜瓣角膜缘干细胞移植
凌萍	广东省佛山市第二人民医院眼科	临床眼科杂志	85例眼红斑痤疮临床分析
刘东敬	四川大学华西医院眼科中心	国际眼科杂志	翼状胬肉切除、大范围Tenon囊切除联合丝裂霉素C治疗翼状胬肉的临床研究
刘中文	中山大学中山眼科中心	中国实用眼科杂志	碱性成纤维细胞生长因子治疗Sjogren综合征和非Sjogren水液缺乏性干眼疗效观察
刘丹	辽宁医学院附属第一医院眼科	国际眼科杂志	玻璃酸钠滴眼液对翼状胬肉转位术后泪膜恢复的作用
刘丽丹	重庆钢铁公司总医院	中华眼视光学与视觉科学杂志	自体球结膜角巩膜瓣移植治疗复发性翼状胬肉
刘丽丽	首都医科大学附属北京儿童医院眼科	中华实验眼科杂志	先天性阔睑一例
刘丽丽	牡丹江医学院红旗医院眼科	国际眼科杂志	儿童瞬目异常的病因分析
刘丽华	中国内蒙古乌兰浩特市医院眼科	国际眼科杂志	特发性持续性眼睑痉挛1例
刘二华	南华大学附属第一医院眼科	国际眼科杂志	原发性翼状胬肉发病机制和治疗新进展
刘云芳	浙江省湖州市第一人民医院眼科研究所	中华实验眼科杂志	翼状胬肉术后巩膜融解分析
刘云芳	湖州师范学院附属第一医院眼科	国际眼科杂志	翼状胬肉术后角膜屈光状态稳定时间的临床观察
刘云莲	神木县眼科医院	眼外伤职业眼病杂志	眼部碱烧伤相关因素分析
刘亚男	安徽省阜阳市人民医院眼科	眼外伤职业眼病杂志	羊膜移植在眼表疾病中的应用
刘伟	中国湖南省湘潭市中心医院眼科	国际眼科杂志	纤维蛋白胶联合绷带型角膜接触镜在翼状胬肉切除术中的应用
刘伟	中国陕西省西安市第四人民医院眼科	国际眼科杂志	西安周边50岁及以上农村人口眼病调查
刘作衡	中国人民解放军第四○四医院眼科	中国眼耳鼻喉科杂志	自体角膜缘干细胞移植术治疗翼状胬肉80例
刘俊茹	石家庄市中心医院眼科	中华眼科杂志	翼状胬肉术后结膜印记细胞学及临床疗效观察
刘元真	南阳市中心医院眼科	中华实验眼科杂志	囊腔内注射治疗结膜囊肿32例
刘先宁	陕西省眼科研究所	国际眼科杂志	衣原体单克隆抗体胶体金法测定沙眼衣原体
刘先宁	中国西安市眼科研究所	国际眼科杂志	丫啶橙荧光染色结膜印迹细胞定量检测干燥性角结膜炎
刘克兰	山西省眼科医院病理科	中国实用眼科杂志	翼状胬肉中Ki-67和VEGF的表达
刘克述	新疆昌吉州人民医院	眼外伤职业眼病杂志	羊膜移植与平阳霉素治疗翼状胬肉的临床观察
刘克龙	山东省莘县眼科医院	中华眼视光学与视觉科学杂志	结膜囊吸吮线虫病五例
刘兰	武汉大学中南医院眼科	国际眼科杂志	综合治疗复发性翼状胬肉疗效观察
刘兴强	东营市人民医院	眼外伤职业眼病杂志	纤维蛋白胶在翼状胬肉切除联合自体角膜缘干细胞移植术中的应用研究
刘兴强	山东省东营市人民医院	中国中医眼科杂志	改良翼状胬肉剥离联合角膜缘干细胞移植在翼状胬肉手术中的应用
刘兴标	广西河池市第三人民医院眼科	临床眼科杂志	翼状胬肉切除联合带角膜缘上皮的自体结膜瓣移植术152例疗效观察
刘军	山东莱芜市莱城区人民医院	临床眼科杂志	淋菌性结膜炎合并衣原体感染分析
刘军彩	山东省眼科研究所	中华实验眼科杂志	丝状角膜炎角膜丝状物构成分析
刘凌	广东医学院附属医院眼科	国际眼科杂志	翼状胬肉组织中Bcl-2和ICAM-1的表达
刘凌	浙江省衢州市人民医院眼科	眼外伤职业眼病杂志	自体角膜缘干细胞移植联合贝复舒治疗翼状胬肉
刘凤阁	中国山东省邹城市人民医院眼科	国际眼科杂志	大范围切除联合新鲜羊膜移植治疗复发性翼状胬肉
刘凤阁	邹城市人民医院	眼外伤职业眼病杂志	自体角膜缘干细胞联合结膜移植治疗翼状胬肉
刘凯波	湖北省荆州市公安县第一人民医院眼科	中国实用眼科杂志	翼状胬肉显微切除联合丝裂霉素C加自体带角膜缘上皮结膜移植术观察
刘刚	河南省直第三人民医院眼科	国际眼科杂志	旋转结膜瓣治疗翼状胬肉的远期疗效
刘勇	第三军医大学西南医院	中国实用眼科杂志	原发性结膜肿瘤728例临床病理分析
刘勤	甘肃省人民医院	眼外伤职业眼病杂志	表皮生长因子在翼状胬肉术后的应用观察
刘华	绵阳万江眼科医院眼科	国际眼科杂志	带蒂结膜瓣移植联合MMC治疗翼状胬肉合并结膜松弛症
刘卫	中国人民解放军石家庄医学高等专科学校	中国中医眼科杂志	柳叶液抑制肠病毒70型的体外实验研究
刘卫东	浙江慈溪市庵东中心医院眼科	中国中医眼科杂志	角膜缘干细胞移植治疗复发性翼状胬肉
刘卫华	北京大学第三医院	眼外伤职业眼病杂志	胚胎角膜干细胞移植治疗翼状胬肉的远期临床观察
刘名皎	海南省人民医院	眼外伤职业眼病杂志	辅用丝裂霉素的巩膜暴露法翼状胬肉手术
刘向	广东省佛山市禅城区中心医院眼科	中国眼耳鼻喉科杂志	翼状胬肉术后巩膜融解2例
刘向利	北京医院眼科	中华眼视光学与视觉科学杂志	我国开展角膜塑型术的现状及问题
刘嘉立	成都中医药大学	中国中医眼科杂志	苦参碱对体外培养人翼状胬肉成纤维细胞增殖的影响
刘国义	景泰县中医院眼科	眼科	翼状胬肉恶变鳞状细胞癌一例
刘国新	资兴矿业集团总医院	眼外伤职业眼病杂志	翼状胬肉的三种手术方法疗效比较
刘增业	河北省职工医学院附属医院眼科	眼科	部分切除并联合自体角膜上皮干细胞移植治疗翼状胬肉
刘太琴	山西医科大学第一医院耳鼻咽喉科变态反应室	中华眼科杂志	过敏性结膜炎变应原检查
刘奎香	青岛大学医学院附属医院眼科	国际眼科杂志	复发性翼状胬肉的治疗分析
刘妍	中国湖南省湘潭市中心医院眼科	国际眼科杂志	纤维蛋白胶联合绷带型角膜接触镜在翼状胬肉切除术中的应用
刘姣	中国广东省肇庆市第一人民医院眼科	国际眼科杂志	翼状胬肉联合羊膜移植手术失败的临床分析
刘娅莉	四川大学华西医院眼科中心	国际眼科杂志	翼状胬肉切除、大范围Tenon囊切除联合丝裂霉素C治疗翼状胬肉的临床研究
刘娟	安徽省凤台县人民医院眼科	临床眼科杂志	自体角膜缘干细胞移植治疗翼状胬肉
刘子彬	中国人民解放军第421医院眼科	国际眼科杂志	顺逆行切除术联合丝裂霉素治疗翼状胬肉的疗效
刘孝书	中国中医研究院广安门医院眼科	中国中医眼科杂志	复方熊胆滴眼液治疗急性卡他性结膜炎临床观察
刘学仁	庆阳市人民医院	眼外伤职业眼病杂志	翼状胬肉手术三种不同术式的疗效分析
刘学仁	甘肃省庆阳市人民医院	中国眼耳鼻喉科杂志	自体角膜缘干细胞移植治疗眼表面疾病
刘学文	新疆维吾尔自治区若羌县人民医院	中国中医眼科杂志	巴音郭楞蒙古自治州5县市翼状胬肉患病率的调查
刘宏伟	北京同仁眼科中心北京市眼科学与视觉科学重点实验室北京市眼科研究所	中国中医眼科杂志	秦菊滴眼液治疗家兔实验性结膜炎的实验研究
刘宗明	河北省张家口市第四医院眼科	中国实用眼科杂志	非炎性坏死性巩膜溃疡
刘定军	绵阳市富临医院	眼外伤职业眼病杂志	无缝隙缝合带角膜缘干细胞结膜瓣术治疗翼状胬肉
刘寨花	山西医科大学第二附属医院眼科	中国斜视与小儿眼科杂志	翼状胬肉患者泪液中表皮生长因子的含量分析
刘小伟	中国医学科学院北京协和医院眼科	国际眼科杂志	过敏性眼表疾病临床现状分析
刘小阳	湖南省人民医院眼科	中国中医眼科杂志	白内障术前清洁结膜囊方法的比较
刘岚	湖南省怀化医专附属医院暨怀化市三人民医院眼科	中国实用眼科杂志	原发性翼状胬肉的两种手术治疗的疗效比较
刘巨平	天津医科大学眼科中心	国际眼科杂志	云南省怒江州贡山县翼状胬肉的流行病学调查
刘庆淮	南京医科大学第一附属医院眼科	中国眼耳鼻喉科杂志	原发性翼状胬肉760例术后复发情况分析
刘庚勋	解放军第一六三医院病理科	中华眼科杂志	翼状胬肉中诱导一氧化氮合酶与FⅧ相关抗原表达的研究
刘庚勋	解放军第一六三医院病理科	中国实用眼科杂志	FⅧ-RAg VEGF在翼状胬肉中表达和微血管密度检测及其意义
刘庚辰	平顶山市第二人民医院	眼外伤职业眼病杂志	自体角膜缘干细胞移植治疗翼状胬肉
刘建君	郑州市第二人民医院眼科	眼外伤职业眼病杂志	翼状胬肉不同手术方法的疗效比较
刘建生	福建省漳州市芝山卫生院眼科	眼外伤职业眼病杂志	平阳霉素滴眼预防翼状胬肉术后复发的观察
刘建生	漳州市芗城区通北社区卫生服务中心	眼外伤职业眼病杂志	平阳霉素滴眼预防翼状胬肉术后复发
刘建荣	郑州市第二人民医院眼科	眼外伤职业眼病杂志	翼状胬肉手术中无缝线自体角膜缘干细胞移植
刘开太	郴州市第三人民医院	眼科	不同术式的翼状胬肉手术疗效分析
刘彦红	内蒙古医学院第三附属医院眼科	临床眼科杂志	人羊膜移植治疗翼状胬肉的临床观察
刘德平	青州眼科医院潍坊医学院卫生统计学教研室	中国实用眼科杂志	青州市农村≥60岁居民眼疾病状况及未就诊影响因素分析
刘德申	山东省滨州市中心医院眼科	中国实用眼科杂志	翼状胬肉切除角膜缘重建术后无菌性巩膜融解
刘志宏	中国全国中医白内障医疗中心	国际眼科杂志	返魂草滴眼液治疗细菌性结膜炎的疗效观察
刘志恒	天津市大港医院眼科	中国中医眼科杂志	丝裂霉素C在翼状胬肉切除术中的应用
刘志英	包头医学院第一附属医院眼科	国际眼科杂志	沙眼诊断和治疗的研究进展
刘志英	内蒙古科技大学第一附属医院眼科	中华实验眼科杂志	内蒙古赤峰市克什克腾旗中小学生沙眼流行病学调查
刘思维	同济大学附属同济医院眼科	眼外伤职业眼病杂志	前段光学相干断层成像测量翼状胬肉术后结膜植片厚度的临床研究
刘惠芸	山东省威海市职工医院眼科	临床眼科杂志	翼状胬肉术后霉菌性角膜溃疡2例
刘慧	天津医科大学眼科医院	国际眼科杂志	纤维蛋白胶在翼状胬肉切除联合自体角膜缘干细胞移植术中的临床效果
刘慧	天津医科大学眼科研究所	国际眼科杂志	表面麻醉下翼状胬肉手术中应用纤维蛋白胶的效果
刘文洁	天津医科大学眼科中心	国际眼科杂志	云南省怒江州贡山县翼状胬肉的流行病学调查
刘文舟	中国宁夏回族自治区银川市	国际眼科杂志	绿脓杆菌性角膜溃疡抢救成功1例
刘文舟	解放军第五医院眼科	眼外伤职业眼病杂志	贝复舒滴眼液在翼状胬肉术后的应用
刘文舟	解放军第五医院	眼外伤职业眼病杂志	羊膜移植治疗眼表疾病临床观察
刘新	福州市第二医院眼科	中国实用眼科杂志	翼状胬肉的发生与角膜缘干细胞缺乏的病理研究
刘新	中国福建省福州市第二医院眼科	国际眼科杂志	翼状胬肉的治疗进展
刘新亚	江苏省省级机关医院	临床眼科杂志	羊膜移植在眼表疾病中的应用观察
刘明玉	漳州市医院眼科	眼科	自体结膜瓣转位移植治疗翼状胬肉
刘春民	暨南大学附属深圳眼科中心	国际眼科杂志	两种药物治疗变态反应性结膜炎的疗效观察
刘春民	中国广东省深圳市眼科医院小儿眼科	国际眼科杂志	盐酸氮卓斯汀滴眼液治疗儿童变态反应性结膜炎的疗效
刘昭升	厦门大学附属厦门眼科中心	国际眼科杂志	翼状胬肉组织Caveolin-1,E-cadherin和P63的表达
刘是	中国陕西省西安市第四人民医院眼科	国际眼科杂志	西安周边50岁及以上农村人口眼病调查
刘晓	大连市中心医院	眼外伤职业眼病杂志	羊膜移植眼表重建术的临床观察
刘晓	中国青海省四宁市	国际眼科杂志	自体干细胞移植治疗翼状胬肉50例疗效观察
刘晓	青海省中医院眼科	临床眼科杂志	显微自体干细胞移植治疗50例翼状胬肉临床疗效观察
刘晓娟	泰兴市人民医院	眼外伤职业眼病杂志	生物羊膜移植治疗复发性翼状胬肉临床观察
刘晓存	青州眼科医院潍坊医学院卫生统计学教研室	中国实用眼科杂志	青州市农村≥60岁居民眼疾病状况及未就诊影响因素分析
刘晓宁	中国江苏省镇江市第一人民医院眼科	国际眼科杂志	急性结膜炎愈后主诉干眼症状泪膜稳定性初探
刘晓荣	兰州军区乌鲁木齐总医院	中华实验眼科杂志	沙眼衣原体两种基因诊断方法的比较
刘晓荣	兰州军区乌鲁木齐总医院眼科	中华实验眼科杂志	维汉民族中学生沙眼衣原体感染调查
刘晔翔	上海中医药大学附属普陀医院	中华眼科杂志	结膜松弛症球结膜组织中热休克蛋白的表达
刘朝华	浙江省缙云县人民医院眼科	眼外伤职业眼病杂志	丝裂霉素C在首次复发性翼状胬肉中的应用
刘朝盛	陕西省汉中市中心医院	眼外伤职业眼病杂志	自体角膜缘干细胞移植治疗翼状胬肉效果分析
刘李平	中国新疆维吾尔自治区乌鲁木齐市	国际眼科杂志	翼状胬肉标准化手术治疗的疗效
刘杏	中山大学中山眼科中心眼科学国家重点实验室	中华眼科杂志	透明质酸钠对兔含苯扎氯铵溴莫尼定眼表毒性保护作用的研究
刘杰	解放军总医院第一附属医院眼科	国际眼科杂志	自体角膜缘干细胞移植与自体体外培养角膜干细胞移植治疗翼状胬肉临床观察
刘杰	解放军总医院304临床部眼科	国际眼科杂志	体外培养自体角膜缘干细胞移植术治疗翼状胬肉1例
刘桂芬	中国河北省邯郸市眼科医院	国际眼科杂志	翼状胬肉手术治疗研究进展
刘桂芬	河北邯郸市眼科医院眼科	中国实用眼科杂志	翼状胬肉切除联合准分子激光治疗性角膜切削术与角膜缘干细胞移植术疗效对比观察
刘桂芬	邯郸眼科医院眼科	国际眼科杂志	应用准分子激光角膜切削术治疗翼状胬肉的临床观察
刘森玉	内蒙古自治区人民医院眼科	临床眼科杂志	羊膜移植联合曲安奈德治疗复发性翼状胬肉的临床观察
刘毅	四川大学华西医院眼科	国际眼科杂志	成都市767例干部体检眼科疾病构成分析
刘水	广东省中山火炬开发区医院眼科	国际眼科杂志	不同手术方式对翼状胬肉患者泪液功能的影响
刘永民	甘肃省兰州市第一人民医院	中国眼耳鼻喉科杂志	自体角膜缘干细胞移植治疗眼表面疾病
刘永琦	甘肃中医学院实验中心	中国中医眼科杂志	自体角膜缘干细胞及羊膜对翼状胬肉TNF-α、IL-6表达的影响
刘永琰	南昌大学第一附属医院眼科	眼外伤职业眼病杂志	翼状胬肉不同术式预防复发的对比研究
刘汉强	中国医科大学附一院眼科	眼外伤职业眼病杂志	准分子激光原位角膜磨镶术后并发病毒性角膜炎一例
刘汉生	海口，海南省人民医院眼科	中华眼科杂志	海南省两县(市)翼状胬肉患病率的调查
刘沈萍	河北北方学院	中国实用眼科杂志	翼状胬肉切除术致迟发型眼-胃肠反射一例
刘沉	江汉油田总医院眼科	国际眼科杂志	生物冻干羊膜移植在复发性翼状胬肉手术中的应用观察
刘治容	四川省人民医院眼科	国际眼科杂志	翼状胬肉术后严重并发症3例
刘洋	华中科技大学同济医学院附属协和医院眼科	中华眼科杂志	第15例——双眼疼痛并畏光流泪数日
刘洋	武汉大学中南医院眼科	国际眼科杂志	综合治疗复发性翼状胬肉疗效观察
刘洋	固始县中医院	眼外伤职业眼病杂志	三联术治疗翼状胬肉效果观察
刘洋	中国陕西省延安市人民医院眼科	国际眼科杂志	复发性翼状胬肉逆行切除包埋加自体角膜缘干细胞移植术疗效观察
刘浇艺	广东省中山火炬开发区医院眼科	国际眼科杂志	不同手术方式对翼状胬肉患者泪液功能的影响
刘浩	菏泽地区人民医院眼科	中华实验眼科杂志	3365名中学生沙眼患病分析
刘海	昆明医学院第四附属医院眼科	中华实验眼科杂志	睑缘切开带蒂轮匝肌瓣充填术治疗严重上睑内翻倒睫疗效观察
刘海俊	中国人民解放军第四二一医院眼科	国际眼科杂志	生物羊膜移植联合丝裂霉素和血管抑素治疗复发性翼状胬肉
刘海俊	中国人民解放军第四二一医院眼科	国际眼科杂志	术中应用丝裂霉素治疗不同类型原发性翼状胬肉的疗效观察
刘海俊	中国人民解放军第421医院眼科	国际眼科杂志	顺逆行切除术联合丝裂霉素治疗翼状胬肉的疗效
刘海俊	中国人民解放军第421医院眼科	国际眼科杂志	头孢曲松钠治疗新生儿淋球菌性结膜炎
刘海泉	中国广东省深圳市西乡人民医院眼科	国际眼科杂志	裂隙灯眼前段处理系统在眼科的临床应用
刘淑岩	沈阳爱尔眼视光医院	中国实用眼科杂志	外眦角泪腺排泄管异物二例
刘淑艳	秦皇岛市第二医院眼科	中国中医眼科杂志	蝉花散结合手术治疗复发性翼状胬肉临床观察
刘淑艳	河北省秦皇岛市第二医院眼科	中国中医眼科杂志	撕拉式并钝性分离联合丝裂霉素治疗翼状胬肉的体会
刘炳娇	韶关市第一人民医院	眼外伤职业眼病杂志	羊膜联合自体角膜缘干细胞移植治疗翼状胬肉
刘爱勤	河南省太康县人民医院眼科	眼外伤职业眼病杂志	自体角膜缘干细胞移植治疗翼状胬肉
刘爱平	中国南京大学附属鼓楼医院眼科	国际眼科杂志	盐酸洛美沙星眼凝胶临床生物等效性试验
刘爱英	山东省荣成市人民医院眼科	临床眼科杂志	荣成市渔民翼状胬肉的流行病学调查
刘爽	中国北京市羊坊店医院眼科	国际眼科杂志	泪道阻塞部位的分布特点及相关因素的初步研究
刘玉君	湘南学院附属医院眼科	国际眼科杂志	不同手术方式翼状胬肉切除术后巩膜并发症的临床研究
刘玉强	潍坊眼科医院	临床眼科杂志	角膜磨削联合角膜缘干细胞移植术治疗翼状胬肉疗效观察
刘现忠	河南省直第三人民医院眼科	国际眼科杂志	旋转结膜瓣治疗翼状胬肉的远期疗效
刘琳琳	河南省新乡市第一人民医院眼科	眼外伤职业眼病杂志	翼状胬肉术联合药物应用的临床观察
刘畅	辽宁省人民医院眼科	国际眼科杂志	翼状胬肉切除联合自体角膜缘干细胞移植术疗效分析
刘祁广	中国湖南省长沙市	国际眼科杂志	春季角结膜炎的治疗进展
刘祖国	厦门大学附属眼科中心厦门大学眼科研究所	中华眼科杂志	翼状胬肉上皮鳞状化生与泪膜稳定性的研究
刘祖国	厦门大学眼科研究所	中华眼科杂志	努力提高我国翼状胬肉的手术水平
刘祖国	中山大学中山眼科中心	中华眼科杂志	急性结膜炎痊愈后泪膜的变化
刘祖国	中山大学眼表疾病研究中心	中华眼科杂志	提高我国常见眼表疾病的诊断与治疗水平
刘祖国	中山大学中山眼科中心	中国实用眼科杂志	翼状胬肉切除对泪液功能的影响
刘祖国	中山大学中山眼科中心	中华眼科杂志	羊膜移植重建静止期眼结膜表面的远期疗效分析
刘祖国	中山大学中山眼科中心	中华眼科杂志	干眼患者115例的临床特点分析
刘祖国	中山大学眼表疾病研究中心	中国实用眼科杂志	过敏性结膜炎的临床特点
刘祖国	厦门大学医学院	中华实验眼科杂志	翼状胬肉细胞之间的相互作用
刘祖国	中山大学中山眼科中心	中华眼科杂志	翼状胬肉上皮细胞p53蛋白的表达及其功能状态的研究
刘祖国	中山大学中山眼科中心	中国实用眼科杂志	翼状胬肉与正常角膜和结膜的PEDF和VEGF水平
刘祖国	厦门大学医学院眼科研究所	中华眼科杂志	双眼蚕蚀性角膜溃疡伴翼状胬肉一例
刘祖国	中山大学中山眼科中心	中华眼科杂志	过敏性结膜炎的诊治
刘秀明	第二军医大学长征医院眼科	国际眼科杂志	HTLV-1感染者的眼部临床表现
刘秀明	第二军医大学附属长征医院眼科	临床眼科杂志	结膜瓣转移与羊膜移植治疗复发性翼状胬肉的疗效对比分析
刘素芬	河北省保定市第一中心医院眼科	临床眼科杂志	羊膜移植在复发性翼状胬肉手术中的应用
刘红	复旦大学附属眼耳鼻喉科医院眼科	眼科	奥洛他定治疗儿童过敏性结膜炎合并瞬目频繁的疗效观察
刘红云	湖北省十堰市东风汽车公司茅箭医院眼科	眼外伤职业眼病杂志	翼状胬肉术后复发的防治探讨
刘绍峰	安徽省黄山市解放军532医院眼科	中国实用眼科杂志	乙醇松解翼状胬肉切除联合角膜缘上皮移植的疗效观察
刘绍燕	中国中医科学院眼科医院	中国中医眼科杂志	目痒证治1例
刘继华	中国广东省深圳市宝安区石岩人民医院眼科	国际眼科杂志	自体角膜缘干细胞移植术与传统术式治疗翼状胬肉的对比研究
刘美荣	山东省单县中心医院眼科	中华眼视光学与视觉科学杂志	成年人淋菌性角膜溃疡一例
刘翔云	山东滕州市中心人民医院眼科	中国眼耳鼻喉科杂志	钝性分离胬肉联合自体角膜缘移植治疗翼状胬肉
刘翠娥	山东省烟台市烟台山医院眼科	中国实用眼科杂志	角膜缘干细胞移植治疗翼状胬肉
刘聪慧	成都中医药大学	中国中医眼科杂志	苦参碱对体外培养人翼状胬肉成纤维细胞增殖的影响
刘艳辉	广东省人民医院病理科	中华眼科杂志	移植物抗宿主病相关的干眼病
刘芳	中国江苏省苏州市眼视光医院眼科	国际眼科杂志	酒精浸泡剥离法在翼状胬肉手术中的疗效观察
刘芳	中国湖北省潜江市中心医院眼科	国际眼科杂志	聚四氟乙烯联合角膜缘干细胞移植治疗复发性翼状胬肉并睑球粘连
刘英君	中国人民解放军第273医院眼科	中国中医眼科杂志	库尔勒市中老年人翼状胬肉的流行病学特点
刘荣	华中科技大学同济医学院附属同济医院眼科	中华眼科杂志	糖皮质激素性高眼压患者外周血单个核细胞糖皮质激素受体α和β的表达
刘荣春	解放军145医院	眼外伤职业眼病杂志	霰粒肿刮匙在沙眼滤泡摩擦术中的应用
刘莉	黄石爱尔眼科医院	国际眼科杂志	翼状胬肉上结膜反向移植联合羊膜移植治疗复发胬肉
刘莎利	云南省玉溪市人民医院眼科	中华眼科杂志	结膜真菌病误诊一例
刘莎莉	玉溪市第一人民医院眼科	中国中医眼科杂志	新生儿淋菌性结膜炎的疗效观察
刘蓉	中国上海市徐汇区凌云街道社区卫生服务中心眼耳鼻喉科	国际眼科杂志	改良逆行撕剥术联合自体结膜瓣移植治疗翼状胬肉的临床观察
刘蓉	南京医科大学附属南京第一医院眼科	国际眼科杂志	翼状胬肉切除术前与术后角膜变化的研究
刘蕾	中国辽宁省沈阳市第四人民医院眼科	国际眼科杂志	糖皮质激素眼液在流行性角结膜炎治疗中的应用
刘谦虚	江西省宜丰县人民医院五官科	眼外伤职业眼病杂志	角膜异物剔除翼状胬肉切除手术致前房积血一例
刘辅蓉	成都爱尔眼科医院	国际眼科杂志	复发性翼状胬肉33眼手术疗效观察
刘运甲	伊川县卫校附属医院	中华实验眼科杂志	双氯灭痛治疗春季结膜炎
刘运甲	河南省伊川县卫校附属医院	眼外伤职业眼病杂志	带蒂结膜瓣移植术治疗翼状胬肉的临床观察
刘进才	中国人民解放军石家庄医学高等专科学校	中国中医眼科杂志	柳叶液抑制肠病毒70型的体外实验研究
刘都红	山东省滕州市中心医院眼科	临床眼科杂志	急性结膜囊肿1例
刘银环	嘉峪关市人民医院	眼外伤职业眼病杂志	翼状胬肉撕离联合带角膜缘结膜瓣转位术疗效观察
刘银萍	安徽海螺集团公司总医院眼科宁国	中华实验眼科杂志	人羊膜联合自体角膜缘移植治疗复发性翼状胬肉
刘锐	第三军医大学西南医院眼科	眼外伤职业眼病杂志	翼状胬肉两种不同术式临床疗效对比
刘阳	北京市眼科研究所	眼科	翼状胬肉组织病理学研究及相关因子的检测
刘雁	重庆三峡中心医院眼科	国际眼科杂志	翼状胬肉切除联合丝裂霉素C及羊膜移植
刘雁庭	新疆昌吉州人民医院眼科	临床眼科杂志	丝裂霉素C眼科应用引起巩膜溶解临床报告
刘雅	中国中医研究院广安门医院眼科	中国中医眼科杂志	复方熊胆滴眼液治疗急性卡他性结膜炎临床观察
刘雅慧	天津市静海县医院眼科	临床眼科杂志	角膜缘干细胞移植治疗翼状胬肉临床疗效观察
刘雨林	青州眼科医院潍坊医学院卫生统计学教研室	中国实用眼科杂志	青州市农村≥60岁居民眼疾病状况及未就诊影响因素分析
刘霞	河北邯郸市眼科医院眼科	中国实用眼科杂志	翼状胬肉切除联合准分子激光治疗性角膜切削术与角膜缘干细胞移植术疗效对比观察
刘霞	中国山东省青岛市经济技术开发区第一人民医院眼科	国际眼科杂志	翼状胬肉术后角膜融解2例临床分析
刘青霞	宁夏回族自治区人民医院宁夏眼科医院	国际眼科杂志	宁夏地区沙眼患病率流行病学调查
刘青霞	宁夏回族自治区人民医院宁夏眼科医院	国际眼科杂志	宁夏地区翼状胬肉患病率的流行病学调查
刘青霞	宁夏回族自治区人民医院宁夏眼科医院	国际眼科杂志	小牛血去蛋白提取物眼用凝胶对复发性翼状胬肉术后角膜切口修复的疗效观察
刘靖	厦门大学医学院眼科研究所	中华眼科杂志	双眼蚕蚀性角膜溃疡伴翼状胬肉一例
刘静	海军总医院海空勤体检中心眼科	中国中医眼科杂志	上泪小管炎误诊为角结膜炎1例
刘颖	复旦大学附属眼耳鼻喉科医院耳鼻喉科	中国眼耳鼻喉科杂志	不同螨致敏原对变应性鼻炎患者生活质量的影响
刘鹏飞	解放军第25医院眼科	眼外伤职业眼病杂志	翼状胬肉术后并发症三例报告
劉洪新	中國遼寧省遼陽縣第一人民醫院眼科	国际眼科杂志	絲裂霉素C在翼狀胬肉手術中的應用
劉澤旭	中國沈陽何氏眼科醫院，	国际眼科杂志	帶蒂球結膜與角膜緣上皮移植治療翼狀胬肉
劉精鋒	中國江西省吉安市中心人民醫院眼科	国际眼科杂志	人羊膜移植治療翼狀胬肉的臨床分析
包兴旺	浙江省长兴县人民医院眼科	中国眼耳鼻喉科杂志	两种术式治疗翼状胬肉的疗效对比
包扬俊	东阳市横店医院	眼外伤职业眼病杂志	逆向切除联合羊膜移植治疗翼状胬肉临床观察
包银秀	巢湖市脱氏眼科医院	眼外伤职业眼病杂志	角膜缘干细胞移植与丝裂霉素C治疗翼状胬肉
匡先琼	湖北省仙桃市中医院眼科	临床眼科杂志	翼状胬肉切除结膜瓣转位包埋术疗效观察
华宁	天津医科大学眼科中心	国际眼科杂志	云南省怒江州贡山县翼状胬肉的流行病学调查
华峰	浙江省苍南县人民医院眼科	中国实用眼科杂志	儿童糖皮质激素性青光眼或高眼压23例临床分析
华焱军	郧阳医学院附属太和医院眼科	眼外伤职业眼病杂志	翼状胬肉埋藏法113例
华远锋	郧阳医学院附属十堰市人民医院眼科	国际眼科杂志	YAG泪道激光联合丝裂霉素及典必殊眼膏治疗泪道阻塞89例
单保生	济宁医学院附属金乡医院	眼外伤职业眼病杂志	自体角膜缘干细胞移植治疗翼状胬肉
单海冬	复旦大学附属眼耳鼻喉科医院眼科	中华眼底病杂志	经双目间接检眼镜激光光凝治疗严重早产儿视网膜病变
卜继普	中国湖南省浏阳市眼科医院眼科	国际眼科杂志	自体结膜移植术联合丝裂霉素C治疗复发性翼状胬肉
卞静	解放军第25医院眼科	眼外伤职业眼病杂志	翼状胬肉术后并发症三例报告
卢嘉彪	中山大学中山眼科中心	中国实用眼科杂志	新生儿急性细菌性结膜炎细菌培养结果分析
卢国强	北华大学附属医院眼科	中华眼底病杂志	双眼后巩膜炎一例
卢多亮	济源市计划生育指导站	眼外伤职业眼病杂志	原发性翼状胬肉术后90Sr敷贴治疗临床观察
卢建香	焦作市第二人民医院眼科	中华实验眼科杂志	90Sr敷贴治疗复发性翼状胬肉疗效分析
卢建香	焦作市第二人民医院眼科	眼外伤职业眼病杂志	原发性翼状胬肉术后90Sr敷贴治疗临床观察
卢成戎	海军总医院眼科	国际眼科杂志	急性结膜炎伴发脓液潴留性囊肿1例
卢毅	益阳医学高等专科学校附属医院眼科	国际眼科杂志	不同翼状胬肉手术方式对角膜屈光的影响
卢江	无锡第三人民医院	中华眼视光学与视觉科学杂志	三种衣原体感染与人类角膜结膜炎的关系
卢洪洲	上海市公共卫生临床中心	中华眼视光学与视觉科学杂志	上海市艾滋病初诊患者眼部并发症及致盲原因调查分析
卢燕	四川省自贡市第一人民医院	眼科	自体角膜缘干细胞联合羊膜移植治疗复发性翼状胬肉
卢玺	武警总医院眼科	国际眼科杂志	泪道阻塞部位的分布特点及相关因素的初步研究
卢笛	沈阳市爱尔眼视光医院	中国实用眼科杂志	自体角膜缘干细胞移植联合丝裂霉素C治疗翼状胬肉疗效观察
卢艳	首都医科大学宣武医院眼科	国际眼科杂志	眼科局部用药的毒性反应分析
卢艳华	广州市番禺区何贤纪念医院眼科	中国实用眼科杂志	基层医院早产儿视网膜病变筛查方式及筛查标准探讨
卢莹	洛阳市中心医院	眼外伤职业眼病杂志	羊膜与自体角膜缘结膜移植治疗翼状胬肉疗效对比
卢跃龙	新疆昌吉州人民医院	眼外伤职业眼病杂志	羊膜移植与平阳霉素治疗翼状胬肉的临床观察
卢银波	广西中医学院附属瑞康医院眼科	国际眼科杂志	角膜塑形镜治疗青少年近视的临床观察
卫冬	牡丹江医学院红旗医院一门诊眼2科	眼外伤职业眼病杂志	铁水烧伤继发假性翼状胬肉的治疗一例
卫红英	武警青海总队医院检验科	临床眼科杂志	沙眼衣原体与沙眼的研究进展
卫钦锋	西宁市第二人民医院眼科	眼外伤职业眼病杂志	非洲贫困地区翼状胬肉切除联合自体角膜缘干细胞移植
古再丽·吐拉甫	中国新疆维吾尔自治区喀什地区第二人民医院眼科	国际眼科杂志	维吾尔族翼状胬肉自体角膜干细胞移植128例疗效分析
古尼沙	和静县人民医院五官科	眼科	蝇蛆引起急性结膜炎一例报告
古志浩	中国广东省梅县人民医院眼科	国际眼科杂志	羊膜移植联合保留球结膜翼状胬肉切除术的临床研究
古志浩	广东省梅县人民医院五官科	中华眼科杂志	广东省梅县盲和低视力流行病学调查
古扎丽努尔	中国新疆维吾尔自治区喀什地区第二人民医院眼科	国际眼科杂志	自体角膜缘干细胞移植治疗维吾尔族翼状胬肉的疗效
史伟云	山东省眼科研究所	中华实验眼科杂志	丝状角膜炎角膜丝状物构成分析
史伟云	山东省眼科研究所山东省眼科医院	中华眼科杂志	翼状胬肉手术中慎用丝裂霉素C
史伟云	山东省眼科研究所、眼科医院	中华眼科杂志	角膜缘干细胞移植术后的穿透性角膜移植疗效观察
史先基	江苏丰县人民医院眼科	眼外伤职业眼病杂志	逆行切除结膜瓣转位治疗翼状胬肉173例
史季桐	首都医科大学北京同仁眼科中心	中华眼科杂志	结膜鳞状细胞癌侵犯眼球内一例
史建江	河北邢台医专第二附属医院眼科	眼外伤职业眼病杂志	结膜吸吮线虫病一例
史慧杰	成武县人民医院眼科	中国中医眼科杂志	中西医结合治疗假膜性结膜炎
史文净	郑州市第三人民医院眼科	眼外伤职业眼病杂志	羊膜移植联合丝裂霉素C治疗复发性翼状胬肉疗效研究
史秀茹	天津医科大学总医院	眼外伤职业眼病杂志	自体角膜缘上皮移植、羊膜移植与常规术式治疗翼状胬肉复发率的比较
史秀茹	天津医科大学总医院眼科	中华实验眼科杂志	羊膜移植治疗兔眼角膜急性期碱烧伤的实验研究
史艳艳	河南省三门峡市中心医院眼科	眼科	96例先天性泪囊炎治疗分析
史跃武	大连市中心医院	眼外伤职业眼病杂志	羊膜移植眼表重建术的临床观察
史铭宇	中国沈阳铁路中心医院眼科	国际眼科杂志	丝裂霉素C在翼状胬肉转移术中的应用
史颖君	枣庄市立医院	眼外伤职业眼病杂志	自体角膜缘干细胞移植与联合羊膜移植治疗进展期翼状胬肉的临床分析
叶丽珊	无锡第三人民医院	中华眼视光学与视觉科学杂志	三种衣原体感染与人类角膜结膜炎的关系
叶云晏	浙江大学医学院附属第二医院眼科	中国眼耳鼻喉科杂志	两种手术方式对翼状胬肉的疗效
叶娟	浙江大学医学院附属第二医院眼科	中国眼耳鼻喉科杂志	两种手术方式对翼状胬肉的疗效
叶小燕	广东省梅县人民医院五官科	中华眼科杂志	广东省梅县盲和低视力流行病学调查
叶成添	中山大学中山眼科中心	眼科	奥洛他定联合FK506滴眼液治疗儿童严重春季角结膜炎的疗效观察
叶梅	厦门眼科中心	中国斜视与小儿眼科杂志	厦门市思明区3～6岁儿童眼病调查
叶永健	江西省遂川县人民医院	中国眼耳鼻喉科杂志	自体部分角膜缘移植治疗复发性翼状胬肉
叶汉元	中国湖北省荆门市第二人民医院眼科	国际眼科杂志	新鲜羊膜移植联合治疗性软性角膜接触镜在治疗翼状胬肉中的应用
叶炳林	广东省三水市人民医院眼科	中国实用眼科杂志	自体和异体角膜缘联合羊膜移植治疗难治翼状胬肉的研究
叶琳	暨南大学附属深圳市眼科医院	国际眼科杂志	泪点炎的临床观察研究
叶纹	上海第二医科大学附属瑞金医院眼科	中华眼科杂志	翼状胬肉中碱性成纤维细胞生长因子的表达及其与肥大细胞的关系
叶茂	中国辽宁省阜新市中心医院眼科	国际眼科杂志	角膜干细胞移植治疗翼状胬肉48例临床分析
叶茹珊	深圳市宝安区人民医院眼科	眼外伤职业眼病杂志	翼状胬肉自体角膜缘干细胞移植术
叶迎冬	湖北省十堰市东风汽车公司茅箭医院眼科	眼外伤职业眼病杂志	翼状胬肉术后复发的防治探讨
叶道祥	中国人民武装警察部队江西总队医院眼科中心	中华眼科杂志	外伤致巩膜层间漏一例
叶采华	温州第二医院	中华眼视光学与视觉科学杂志	新生儿淋菌性结膜炎65例分析
叶锌铭	浙江省丽水市人民医院眼科	中国眼耳鼻喉科杂志	玻璃酸钠滴眼液联合0.02%氟米龙滴眼液治疗急性结膜炎后干眼症
叶青	中国辽宁省阜新市第二医院眼科	国际眼科杂志	角膜干细胞移植治疗翼状胬肉48例临床分析
司马晶	中国广东省深圳市第二人民医院眼科	国际眼科杂志	翼状胬肉切除法与撕除法术后疼痛的对比研究
司马晶	深圳市第二人民医院	中国实用眼科杂志	翼状胬肉与正常角膜和结膜的PEDF和VEGF水平
司马晶	中国广东省深圳市第二人民医院眼科	国际眼科杂志	角膜缘干细胞联合羊膜移植治疗翼状胬肉疗效观察
吉宇莹	陕西省咸阳市第一人民医院眼科	中国实用眼科杂志	自体角膜缘干细胞移植联合丝裂霉素治疗复发性翼状胬肉33例分析
吐尔洪江	中国新疆维吾尔自治区喀什地区第二人民医院眼科	国际眼科杂志	自体角膜缘干细胞移植治疗维吾尔族翼状胬肉的疗效
吕东炜	山东省莘县眼科医院	中华眼视光学与视觉科学杂志	结膜囊吸吮线虫病五例
吕仲平	四川大学华西医院眼科	中华实验眼科杂志	翼状胬肉切除术后继发巨大炎性肉芽肿一例
吕伟	中国河北省邯郸市眼科医院	国际眼科杂志	翼状胬肉手术治疗研究进展
吕同府	衢州市人民医院眼科	眼外伤职业眼病杂志	翼状胬肉撕离联合角膜缘干细胞移植的研究
吕品	中國沈陽何氏眼科醫院，	国际眼科杂志	帶蒂球結膜與角膜緣上皮移植治療翼狀胬肉
吕国钧	辽宁省人民医院眼科	国际眼科杂志	翼状胬肉切除联合自体角膜缘干细胞移植术疗效分析
吕大光	中国黑龙江省哈尔滨市	国际眼科杂志	两种自体结膜移植术治疗原发翼状胬肉疗效比较
吕学峰	湖北省中山医院眼科	中华实验眼科杂志	盐酸奥洛他定联合环孢素A治疗特应性角膜结膜炎临床观察
吕岚	首都医科大学附属北京同仁医院眼科中心	眼科	过敏性结膜炎的流行病学及奥洛他定滴眼液开放性多中心治疗的初步效果
吕彩玲	河南省眼科研究所	眼外伤职业眼病杂志	角膜缘干细胞移植治疗复发性翼状胬肉的护理
吕慧验	山东省日照市人民医院眼科	中国眼耳鼻喉科杂志	带环形巩膜瓣全角膜板层移植术治疗角膜表面衰竭
吕慧验	山东省日照市东港区人民医院眼科	临床眼科杂志	带环形巩膜瓣及角膜缘的全角膜板层移植术治疗蚕蚀性角膜溃疡
吕文秀	中国湖北省黄冈市第一人民医院眼科	国际眼科杂志	自体角膜缘干细胞移植联合羊膜移植术治疗复发性翼状胬肉的临床研究
吕明	华中科技大学同济医学院附属同济医院眼科	临床眼科杂志	重组人干扰素α1b滴眼液对体外培养翼状胬肉成纤维细胞增殖的影响
吕明	华中科技大学同济医学院附属同济医院眼科	中华实验眼科杂志	翼状胬肉发病机制及治疗研究进展
吕晓英	新疆维吾尔自治区人民医院眼科	眼科	先天性眼皮肤黑变病继发青光眼一例
吕沛霖	中国陕西省西安市眼科医院	国际眼科杂志	新鲜羊膜移植治疗复发性翼状胬肉30例
吕涛	中国陕西省安康市中心医院眼科	国际眼科杂志	新鲜羊膜与生物羊膜移植治疗翼状胬肉的临床观察
吕瑾	中国云南省曲靖市第一人民医院眼科	国际眼科杂志	新生儿结膜炎诊断及治疗措施探讨
吕红彬	泸州医学院附属医院眼科	中国实用眼科杂志	2011年泸州市40岁及以上人群翼状胬肉患病率调查
吕红梅	景泰县中医院病理科	眼科	翼状胬肉恶变鳞状细胞癌一例
吕耀辉	西藏军区总医院眼科	眼外伤职业眼病杂志	长时间存留的前房角异物摘出一例
吕萍	山东省泰安市第一人民医院眼科	眼外伤职业眼病杂志	翼状胬肉切除结膜瓣反转式巩膜裸露术疗效观察
吕萍	深圳市中医院	中国中医眼科杂志	化胬抑复冲剂降低翼状胬肉术后复发率的临床研究
吕金华	山东省莘县眼科医院	中华眼视光学与视觉科学杂志	结膜囊吸吮线虫病五例
吕骄	复旦大学附属眼耳鼻喉科医院眼科	中华眼底病杂志	经双目间接检眼镜激光光凝治疗严重早产儿视网膜病变
吴世辉	福建厦门大学医院眼科	中国实用眼科杂志	睑板腺癌误诊1例
吴中耀	中山大学中山眼科中心	中国实用眼科杂志	上穹窿结膜表皮样囊肿的手术治疗
吴仁毅	浙江大学医学院附属第二医院眼科中心	眼科	新鲜羊膜移植在重建健康眼表面中的应用
吴伟	广西北海市合浦卫校附院眼科	眼外伤职业眼病杂志	新鲜人羊膜移植在重建眼表结构中的临床应用
吴伯乐	浙江省丽水市人民医院眼科	中国眼耳鼻喉科杂志	玻璃酸钠滴眼液联合0.02%氟米龙滴眼液治疗急性结膜炎后干眼症
吴俊伟	山东莱芜市莱城区人民医院	临床眼科杂志	淋菌性结膜炎合并衣原体感染分析
吴倩	首都医科大学附属北京儿童医院眼科儿科学国家重点学科	中国斜视与小儿眼科杂志	儿童眼眶蜂窝织炎
吴倩	首都医科大学附属北京儿童医院眼科	中国斜视与小儿眼科杂志	Ritleng 泪道插管术治疗结膜炎导致的儿童继发性泪道阻塞疗效观察
吴倩	首都医科大学附属北京儿童医院眼科	中华实验眼科杂志	先天性阔睑一例
吴健	广西北海市合浦卫校附院眼科	眼外伤职业眼病杂志	新鲜人羊膜移植在重建眼表结构中的临床应用
吴刚	中国陕西省安康市中心医院眼科	国际眼科杂志	羊膜移植联合自体角膜缘移植治疗角膜缘功能衰竭症
吴华新	江苏省盐城市第一人民医院眼科	临床眼科杂志	自体角膜缘干细胞移植术治疗复发性翼状胬肉
吴卫华	广东省汕尾市逸挥基金医院眼科	临床眼科杂志	翼状胬肉角膜表面屈光状态分析
吴双有	中国陕西省安康市中心医院眼科	国际眼科杂志	羊膜移植联合自体角膜缘移植治疗角膜缘功能衰竭症
吴双有	中国陕西省安康市中心医院眼科	国际眼科杂志	新鲜羊膜与生物羊膜移植治疗翼状胬肉的临床观察
吴国夷	兰州军区乌鲁木齐总医院眼科	中华实验眼科杂志	倍诺喜滴眼液致双眼严重角膜损害一例
吴娅娅	温州医学院附属眼视光医院检验科	中华眼视光学与视觉科学杂志	衣氏放线菌致结膜感染1例
吴娟	绵阳万江眼科医院	国际眼科杂志	中药内外合治治疗流行性出血性结膜炎疗效观察
吴宇平	广东省中山火炬开发区医院眼科	国际眼科杂志	不同手术方式对翼状胬肉患者泪液功能的影响
吴宇锋	庆阳市人民医院	眼外伤职业眼病杂志	翼状胬肉手术三种不同术式的疗效分析
吴年浪	杭州市第一人民医院	中华实验眼科杂志	荧光定量聚合酶链反应检测沙眼衣原体
吴建钢	浙江省永嘉县人民医院眼科	眼外伤职业眼病杂志	自体干细胞移植治疗复发性翼状胬肉疗效观察
吴廼川	上海和平眼科医院眼科	国际眼科杂志	激素诱发青光眼或高眼压的临床分析
吴开力	中山大学中山眼科中心	中国实用眼科杂志	正常球结膜与翼状胬肉成纤维细胞生长增殖状况的对比观察
吴开力	中山大学中山眼科中心国家重点实验室	中国中医眼科杂志	初复发翼状胬肉相关因子检测及汉防己甲素作用观察
吴开力	中山大学中山眼科中心中山大学眼科学国家重点实验室	国际眼科杂志	汉防己甲素对翼状胬肉成纤维细胞基质金属蛋白酶的影响
吴开力	中山大学中山眼科中心	国际眼科杂志	β-catenin在翼状胬肉成纤维细胞中的表达
吴开力	中山大学中山眼科中心国家重点实验室	国际眼科杂志	汉防己甲素体外对正常结膜与翼状胬肉成纤维细胞抑制作用的比较
吴开力	中山大学中山眼科中心中山大学眼科学国家重点实验室	国际眼科杂志	汉防己甲素抑制翼状胬肉成纤维细胞增殖的研究
吴强	上海交通大学附属上海市第六人民医院眼科	临床眼科杂志	单纯结膜转位术与联合视原胶原植入术治疗翼状胬肉的疗效观察
吴强	上海交通大学附属第六人民医院眼科	临床眼科杂志	脉络膜黑色素瘤误诊为视网膜脱离1例
吴强	上海交通大学附属上海市第六人民医院眼科	中华实验眼科杂志	翼状胬肉切除联合结膜转位及视原植入术治疗翼状胬肉的疗效观察
吴德银	浙江省金华市人民医院眼科	中国眼耳鼻喉科杂志	翼状胬肉合并结膜松弛症眼表重建的临床观察
吴志兵	安徽海螺集团公司总医院眼科宁国	中华实验眼科杂志	人羊膜联合自体角膜缘移植治疗复发性翼状胬肉
吴志贤	江苏省张家港市第一人民医院眼科	临床眼科杂志	乙醇分离法联合丝裂霉素C治疗翼状胬肉疗效观察
吴志鸿	辽宁抚顺眼病医院	中国实用眼科杂志	冻干人羊膜治疗翼状胬肉的临床观察
吴忠	甘肃省敦煌市医院	临床眼科杂志	高原地区翼状胬肉显微手术治疗疗效观察
吴惠燕	中国福建省云霄县医院眼科	国际眼科杂志	自体角膜缘干细胞移植术治疗原发性翼状胬肉疗效观察
吴戈	温州医学院附属眼视光医院白内障专科	中华眼视光学与视觉科学杂志	衣氏放线菌致结膜感染1例
吴护平	厦门大学附属厦门眼科中心	中华眼科杂志	睑板腺形态学的研究进展
吴护平	厦门市第一医院眼科中心杏林院区	中国实用眼科杂志	羊膜治疗部分眼表疾病的疗效观察
吴护平	厦门大学附属眼科中心厦门大学眼科研究所	中华眼科杂志	翼状胬肉上皮鳞状化生与泪膜稳定性的研究
吴护平	厦门大学附属厦门眼科中心	国际眼科杂志	翼状胬肉组织Caveolin-1,E-cadherin和P63的表达
吴敏	云南省第二人民医院眼科	国际眼科杂志	角膜缘干细胞移植治疗翼状胬肉的远期疗效观察
吴敏	云南省第二人民医院	国际眼科杂志	角膜缘干细胞移植联合羊膜移植治疗复发性翼状胬肉睑球粘连
吴文文	四川大学华西医院眼科	国际眼科杂志	成都市767例干部体检眼科疾病构成分析
吴新华	江苏省常州市中医医院眼科	中国实用眼科杂志	翼状胬肉的眼表改变
吴晓云	广东省深圳市人民医院病案统计室	中国实用眼科杂志	近20年四川省主要视力残疾患病率变化分析
吴晓云	广东省深圳市人民医院病案统计室	中国实用眼科杂志	四川省沙眼20年变迁
吴晓梅	四川大学华西医院眼科	中国实用眼科杂志	双眼Stevens-Johnson综合征误诊1例
吴晓红	中国上海市浦东新区人民医院眼科	国际眼科杂志	自体角膜缘干细胞移植和自体游离球结膜移植治疗翼状胬肉的疗效观察
吴曙华	苏州大学附属第二医院急诊危重病科	中国实用眼科杂志	近20年四川省主要视力残疾患病率变化分析
吴木振	福建省龙岩市第一医院眼科	中国眼耳鼻喉科杂志	慢性结膜炎患者中干眼症的患病率
吴木振	福建省龙岩市第一医院眼科	中国中医眼科杂志	手术切除巨大翼状胬肉1例
吴林彬	中国广东省肇庆市第一人民医院眼科	国际眼科杂志	翼状胬肉联合羊膜移植手术失败的临床分析
吴林彬	中国广东省肇庆市第一人民医院眼科	国际眼科杂志	改良羊膜及角膜缘干细胞移植联合MMC治疗复发性翼状胬肉
吴栋	中国陕西省延安市人民医院眼科	国际眼科杂志	复发性翼状胬肉逆行切除包埋加自体角膜缘干细胞移植术疗效观察
吴欣怡	山东大学齐鲁医院眼科	中国实用眼科杂志	坏死性巩膜炎1例
吴江	海南医学院附属医院	眼外伤职业眼病杂志	两种术式联合丝裂霉素C治疗翼状胬肉
吴江	河南大学淮河医院眼科	中华实验眼科杂志	DNA氧化损伤在翼状胬肉发病中的作用
吴洁	中国陕西省西安市眼科医院	国际眼科杂志	衣原体单克隆抗体胶体金法测定沙眼衣原体
吴洁	中国西安市眼科研究所	国际眼科杂志	丫啶橙荧光染色结膜印迹细胞定量检测干燥性角结膜炎
吴洁	中国陕西省西安市第一医院眼科	国际眼科杂志	原发性翼状胬肉与干眼关系的临床观察
吴海云	广西北海市合浦卫校附院眼科	眼外伤职业眼病杂志	新鲜人羊膜移植在重建眼表结构中的临床应用
吴清波	威宁县中医院眼科	中国中医眼科杂志	中药薰蒸在治疗春季结膜炎中的作用观察
吴烈	中国中医科学院广安门医院眼科	中华实验眼科杂志	小梁切除术后上皮植入性结膜囊肿一例
吴烈	中国中医研究院广安门医院眼科	中国中医眼科杂志	金珠滴眼液治疗慢性结膜炎的临床观察
吴玉宇	南通大学附属医院眼科	中华眼视光学与视觉科学杂志	共焦显微镜对翼状胬肉及其周围角膜的组织病理学观察
吴珺	首都医科大学附属北京同仁医院眼科中心	眼科	充分认识儿童过敏性结膜炎的干眼症问题
吴畅	深圳市龙岗中心医院眼科	眼外伤职业眼病杂志	翼状胬肉手术中羊膜移植与自体角膜缘干细胞移植的效果对比
吴祖鹈	广西北海市合浦卫校附院眼科	眼外伤职业眼病杂志	新鲜人羊膜移植在重建眼表结构中的临床应用
吴秀荣	新疆克拉玛依市第二人民医院眼科	临床眼科杂志	慢性睑缘炎患者泪膜功能的临床分析
吴胜卫	中国北京市通州区潞河医院眼科	国际眼科杂志	显微镜下自体角膜缘干细胞移植治疗翼状胬肉
吴良成	上海市和平眼科医院	中国眼耳鼻喉科杂志	术前控制局部炎症对翼状胬肉术后复发的影响
吴艳	南京军区南京总医院眼科	中华实验眼科杂志	泡性眼炎的激光扫描共焦显微镜下表现
吴艳	南京大学医学院临床学院南京军区南京总医院眼科	中华实验眼科杂志	激光共焦显微镜与组织病理学对翼状胬肉组织中微血管密度研究的比较
吴苇莎	浙江省苍南县人民医院眼科	中国实用眼科杂志	儿童糖皮质激素性青光眼或高眼压23例临床分析
吴莹	中国江苏省南通市第一人民医院眼科	国际眼科杂志	不同术式治疗翼状胬肉的疗效分析
吴莹	南通医学院第二附属医院眼科江苏南通	眼科	低温保存人羊膜移植在重建眼表结构中的临床应用
吴莹	南通市第一人民医院眼科	中华实验眼科杂志	纤维蛋白胶在兔眼翼状胬肉自体结膜瓣转移手术中的应用
吴莹	南通医学院第二附属医院眼科	眼科	单层或多层羊膜移植治疗眼表疾病
吴萍	中國遼宁大連市第二人民醫院眼科	国际眼科杂志	自體角膜缘上皮移植聯合5一氟脲嘧啶治瘵翼狀胬肉的臨床觀察
吴超琼	中国湖北省武汉市第一医院眼科	国际眼科杂志	银杏叶提取物对体外培养翼状胬肉成纤维细胞增殖的抑制作用
吴铁兰	东莞市人民医院眼科	中华实验眼科杂志	干扰素a-2b与丝裂霉素C用于复发性胬肉的临床对比研究
吴雪雁	浙江中医学院附属第三医院、金华市中医院眼科	眼外伤职业眼病杂志	带角膜缘上皮球结膜移植治疗翼状胬肉临床观察
吴青平	福建省三明市第一医院遗传研究室	中华实验眼科杂志	睑结膜部炎症者肺炎衣原体、沙眼衣原体核酸检测
吴青松	中国湖北省恩施州中心医院眼科	国际眼科杂志	自体角膜缘干细胞移植联合MMC对翼状胬肉疗效的Meta分析
吴项	淮南新华医院集团新华医院眼科	临床眼科杂志	淮南市煤矿工人翼状胬肉患病率的流行病学调查
周一鸣	解放军第一六三医院眼科	中华眼科杂志	翼状胬肉中诱导一氧化氮合酶与FⅧ相关抗原表达的研究
周一鸣	解放军第一六三医院眼科	中国实用眼科杂志	FⅧ-RAg VEGF在翼状胬肉中表达和微血管密度检测及其意义
周一龙	嘉兴学院医学院附属嘉兴市第一医院眼科	眼外伤职业眼病杂志	翼状胬肉手术前后屈光变化
周世有	中山大学中山眼科中心	中华眼科杂志	羊膜移植重建静止期眼结膜表面的远期疗效分析
周世有	中山大学眼科学国家重点实验室	中国实用眼科杂志	小牛血去蛋白提取物眼凝胶治疗角膜上皮缺损的多中心临床研究
周丹	中国全国中医白内障医疗中心	国际眼科杂志	返魂草滴眼液治疗细菌性结膜炎的疗效观察
周丽君	河南科技大学第一附属医院眼科	中国眼耳鼻喉科杂志	翼状胬肉的现代微创显微手术治疗
周丽琴	嘉兴学院医学院附属嘉兴市第一医院眼科	眼外伤职业眼病杂志	翼状胬肉手术前后屈光变化
周佳丽	徐州市中心医院眼科	中国实用眼科杂志	丝裂霉素C用于翼状胬肉自体角膜缘干细胞移植的临床分析
周健	大连市中心医院	眼外伤职业眼病杂志	羊膜移植眼表重建术的临床观察
周友根	新干县人民医院	眼外伤职业眼病杂志	角膜缘上皮移植治疗翼状胬肉疗效观察
周和定	宁波市鄞州人民医院	中国实用眼科杂志	翼状胬肉不同术式效果观察
周和政	广州军区武汉总医院	眼外伤职业眼病杂志	板层角膜联合羊膜移植治疗复发性翼状胬肉
周和政	中国湖北武汉广州军区武汉总医院眼科	国际眼科杂志	自体角膜缘上皮联合羊膜移植治疗眼表疾病
周和政	广州军区武汉总医院	眼外伤职业眼病杂志	自体角膜缘干细胞移植治疗复发性翼状胬肉
周和政	广州军区武汉总医院眼科	国际眼科杂志	二期羟基磷灰石义眼台早期植入临床观察
周咏东	南通医学院第二附属医院眼科	眼科	单层或多层羊膜移植治疗眼表疾病
周太星	河源市东源光明眼科医院	眼外伤职业眼病杂志	改良胬肉切除法加自体角膜缘干细胞移植
周妍丽	中国湖北省襄樊市中心医院眼科	国际眼科杂志	结膜吸吮线虫病1例
周妍丽	中国湖北省襄樊市中心医院眼科	国际眼科杂志	高频电灼浚通术治疗泪道阻塞的疗效观察
周宇	武汉科技大学附属天佑医院	眼外伤职业眼病杂志	风湿病患者双眼翼状胬肉术后发生坏死性巩膜炎
周宇	武汉科技大学附属天佑医院眼科	国际眼科杂志	翼状胬肉切除联合自体角膜缘干细胞移植与联合羊膜移植的疗效比较
周家承	中国广东省肇庆市第一人民医院眼科	国际眼科杂志	翼状胬肉联合羊膜移植手术失败的临床分析
周家承	中国广东省肇庆市第一人民医院眼科	国际眼科杂志	改良羊膜及角膜缘干细胞移植联合MMC治疗复发性翼状胬肉
周小平	中国湖南省郴州市第一人民医院眼科	国际眼科杂志	Avastin治疗复发性翼状胬肉的临床研究
周希瑗	重庆医科大学第二附属医院眼科	中国实用眼科杂志	两种矫正退行性下睑外翻手术方法效果比较
周常波	浙江省舟山市普陀人民医院眼科	中国中医眼科杂志	翼状胬肉切除术后辅用中药的疗效观察
周广德	山东省威海市职工医院眼科	临床眼科杂志	翼状胬肉术后霉菌性角膜溃疡2例
周志云	新疆生产建设兵团总医院	眼外伤职业眼病杂志	巩膜表层血管烧灼联合推进式结膜移植治疗翼状胬肉
周慧瑶	沈阳市眼病研究所	中国实用眼科杂志	三重眼表解剖屏障重建术防治翼状胬肉复发四年前瞻性研究
周成超	山东大学公共卫生学院	中华眼科杂志	山东省滕州市2676名农村小学生沙眼患病调查
周敏	中国江苏省镇江市第一人民医院眼科	国际眼科杂志	急性结膜炎愈后主诉干眼症状泪膜稳定性初探
周文宗	河北省沧州眼科医院	中华眼科杂志	板层巩膜移植治愈真菌性巩膜炎一例
周文宗	中国河北省沧州市	国际眼科杂志	河北省沧州城区6~14岁学龄儿童眼病现况调查
周斌	湖北省仙桃市中医院眼科	临床眼科杂志	翼状胬肉切除结膜瓣转位包埋术疗效观察
周晓红	复旦大学附属眼耳鼻喉科医院眼科	中华眼底病杂志	经双目间接检眼镜激光光凝治疗严重早产儿视网膜病变
周晶蓉	绵阳市富临医院	眼外伤职业眼病杂志	无缝隙缝合带角膜缘干细胞结膜瓣术治疗翼状胬肉
周智	甘肃省敦煌市医院	临床眼科杂志	高原地区翼状胬肉显微手术治疗疗效观察
周朝晖	解放军总医院第一附属医院眼科	国际眼科杂志	自体角膜缘干细胞移植与自体体外培养角膜干细胞移植治疗翼状胬肉临床观察
周朝晖	解放军总医院第304临床部眼科	中国实用眼科杂志	羊膜和角膜干细胞移植治疗眼表疾病临床观察
周林	淮安市第二人民医院	眼外伤职业眼病杂志	羊膜移植治疗翼状胬肉临床分析
周欢明	上海中医药大学附属普陀医院眼科	中华眼科杂志	睑板腺功能异常
周正申	上海第二医科大学附属瑞金医院眼科	眼外伤职业眼病杂志	翼状胬肉术中丝裂霉素不同留置时间的效果
周毅	北京同仁眼科中心北京市眼科学与视觉科学重点实验室北京市眼科研究所	中国中医眼科杂志	秦菊滴眼液治疗家兔实验性结膜炎的实验研究
周民稳	中国湖南省郴州市第一人民医院眼科	国际眼科杂志	羊膜移植与结膜瓣转移治疗复发性翼状胬肉的疗效比较
周永祚	中国上海市长宁区中心医院眼科	国际眼科杂志	羊膜移植治疗复发性翼状胬肉32例
周浩	复旦大学附属眼耳鼻喉科医院眼科	眼科	奥洛他定治疗儿童过敏性结膜炎合并瞬目频繁的疗效观察
周海林	上海市眼病防治中心	眼外伤职业眼病杂志	双眼皮质类固醇性青光眼一例
周清	暨南大学附属深圳眼科医院	中国斜视与小儿眼科杂志	新生儿急性细菌性结膜炎病原菌及药物敏感性分析
周灵	惠州市人民医院眼科	中国实用眼科杂志	羊膜移植与自体角膜缘移植治疗翼状胬肉的初步疗效对照
周燕	北京市中关村医院眼科	眼科	90Srβ射线照射预防翼状胬肉术后复发追踪观察
周玉兰	江西省宜丰县人民医院五官科	眼外伤职业眼病杂志	角膜异物剔除翼状胬肉切除手术致前房积血一例
周玉梅	首都医科大学附属同仁医院	中华实验眼科杂志	武强县小学生沙眼流行病学调查
周玉梅	北京市羊坊店医院眼科	中华眼科杂志	沙眼流行情况的研究进展
周玉梅	同仁眼科中心北京市眼科研究所	中华实验眼科杂志	我国北方两地区小学生沙眼衣原体检测及基因分型研究
周玉梅	首都医科大学附属北京同仁医院眼科中心	眼科	沙眼患者临床与实验室诊断研究
周玉梅	北京市羊坊店医院眼科	中华实验眼科杂志	沙眼患者病原体基因型的鉴定分析
周琦	泸州医学院附属医院眼科	中国实用眼科杂志	2011年泸州市40岁及以上人群翼状胬肉患病率调查
周琼	南昌大学第一附属医院眼科	眼外伤职业眼病杂志	翼状胬肉不同术式预防复发的对比研究
周畅达	河北省沧州眼科医院	临床眼科杂志	老年性下睑外翻手术治疗的探讨
周畅达	中国河北省沧州市	国际眼科杂志	河北省沧州城区6~14岁学龄儿童眼病现况调查
周秀花	中国黑龙江省牡丹江市第二人民医院眼科	国际眼科杂志	丝裂霉素C在翼状胬肉切除术中应用
周秀萍	湖北省仙桃市中医院眼科	临床眼科杂志	翼状胬肉切除结膜瓣转位包埋术疗效观察
周箭	安徽省安庆宜城医院眼科	临床眼科杂志	综合治疗翼状胬肉的临床观察
周红	贵州航天医院	眼外伤职业眼病杂志	初发翼状胬肉单纯切除联合丝裂霉素C的治疗观察
周艳红	解放军第四五四医院眼科	眼外伤职业眼病杂志	睑球粘连分离术中应用丝裂霉素C的临床观察
周芳丽	辽宁省营口市中心医院眼科	临床眼科杂志	翼状胬肉切除术后并发结膜囊肿的临床治疗观察
周芳红	中国陕西省宝鸡市中医医院眼科	国际眼科杂志	翼状胬肉病因和治疗与复发干预的临床研究进展
周萍	广州医学院第二附属医院眼科	中华实验眼科杂志	广东地区变应性结膜炎变应原筛选及预防
周萱	甘肃省天水市第二人民医院眼科	临床眼科杂志	平阳霉素局部注射治疗翼状胬肉
周薇薇	暨南大学附属深圳市眼科医院角膜病科	国际眼科杂志	羊膜移植术治疗重症春季卡他性结膜炎的疗效分析
周行涛	复旦大学附属眼耳鼻喉科医院眼科	眼科	奥洛他定治疗儿童过敏性结膜炎合并瞬目频繁的疗效观察
周超	泌阳县人民医院	眼外伤职业眼病杂志	翼状胬肉切除联合角膜缘干细胞移植术观察
周辉	南昌大学第二附属医院眼科	国际眼科杂志	翼状胬肉中MMP-2,TIMP-2和TGF-β1的表达意义
周进	上海交通大学附属第一人民医院松江分院	国际眼科杂志	改良性带蒂结膜瓣移植治疗翼状胬肉的疗效观察
周进	中国上海市松江区中心医院眼科	国际眼科杂志	翼状胬肉基质金属蛋白酶表达的意义
周金霞	中国河北工程学院医学部附属医院防保科	国际眼科杂志	邯郸市区新生儿淋球菌性结膜炎发病的调查
周雄	广州军区武汉总医院	眼外伤职业眼病杂志	板层角膜联合羊膜移植治疗复发性翼状胬肉
周雄	中国湖北武汉广州军区武汉总医院眼科	国际眼科杂志	自体角膜缘上皮联合羊膜移植治疗眼表疾病
周雄	广州军区武汉总医院眼科	国际眼科杂志	二期羟基磷灰石义眼台早期植入临床观察
周雅丽	中国医科大学盛京医院眼科	国际眼科杂志	自体结膜瓣移植治疗翼状胬肉的临床观察
周雨声	宁波市江东眼科医院	中国中医眼科杂志	近视眼LASIK手术后角膜上皮铁线的临床观察
周霞	郧阳医学院附属太和医院眼科	国际眼科杂志	增殖细胞核抗原和胰岛素样生长因子Ⅱ在翼状胬肉组织中的表达
周霞	湖北医药学院附属太和医院眼科	临床眼科杂志	翼状胬肉手术前后对比敏感度和角膜地形图改变的比较
周青	暨南大学附属深圳市眼科医院	中国实用眼科杂志	新生儿急性细菌性结膜炎10年致病菌变迁
周静	金川集团公司职工医院	眼外伤职业眼病杂志	羊膜移植联合丝裂霉素C在复发性翼状胬肉手术中的应用
周颖	海军青岛401医院眼科	眼外伤职业眼病杂志	不同部位角膜干细胞移植治疗翼状胬肉的疗效分析
唐东润	天津市第一中心医院眼科	中国实用眼科杂志	重视眼科影像学检查提高临床诊断率
唐丽萍	解放军第五医院	眼外伤职业眼病杂志	羊膜移植治疗眼表疾病临床观察
唐仁泓	中南大学湘雅三医院眼科	中华实验眼科杂志	HIF-1与VEGF在翼状胬肉中的表达及意义
唐仁泓	中南大学湘雅三医院眼科	中国实用眼科杂志	XIAP和COX-2在翼状胬肉中的表达及其相关性研究
唐光任	广西北海市合浦卫校附院眼科	眼外伤职业眼病杂志	新鲜人羊膜移植在重建眼表结构中的临床应用
唐兵华	中国四川省成都市第一人民医院眼科	国际眼科杂志	翼状胬肉切除联合角膜缘干细胞移植及术后药物治疗临床观察
唐勋伦	永州市眼科研究所	眼外伤职业眼病杂志	翼状胬肉术后滴用重组人表皮生长因子的疗效
唐国芬	承德医学院附属医院	眼科	干眼症患病因素的临床分析
唐孟林	湖南省永州市人民医院	中国实用眼科杂志	保存羊膜与新鲜羊膜治疗眼表疾病的比较研究
唐孟林	湖南省永州市人民医院眼科	眼外伤职业眼病杂志	翼状胬肉不同术式效果的对比观察
唐学玲	浙江省人民医院眼科	眼外伤职业眼病杂志	翼状胬肉术后β射线防复治疗的疗效观察
唐建明	中国上海市宝山区中心医院眼科	国际眼科杂志	激素诱发青光眼或高眼压的临床分析
唐彦慧	中国广西壮族自治区南宁市第一人民医院眼科	国际眼科杂志	大规模白内障复明手术中同时行胬肉切除联合球结膜瓣转移手术的应用
唐志平	湖南省怀化医专附属医院暨怀化市三人民医院眼科	中国实用眼科杂志	原发性翼状胬肉的两种手术治疗的疗效比较
唐文丽	上海市眼病防治中心	眼外伤职业眼病杂志	双眼皮质类固醇性青光眼一例
唐晓荣	湖南省儿童医院眼科	国际眼科杂志	婴幼儿泪囊炎的治疗综述
唐浩英	广东省三水市人民医院眼科	中国实用眼科杂志	自体和异体角膜缘联合羊膜移植治疗难治翼状胬肉的研究
唐玉玲	中国黑龙江省牡丹江市第二人民医院眼科	国际眼科杂志	丝裂霉素C在翼状胬肉切除术中应用
唐玉花	深圳市龙岗中心医院眼科	眼外伤职业眼病杂志	翼状胬肉手术中羊膜移植与自体角膜缘干细胞移植的效果对比
唐知进	四川省遂宁市人民医院眼科	临床眼科杂志	结角膜鳞状细胞癌1例
唐知进	中国四川省遂宁市中心医院眼科	国际眼科杂志	翼状胬肉不同术式治疗后1a内复发率的比较
唐秀武	广西壮族自治区民族医院眼科	国际眼科杂志	自体血清结膜下注射治疗过敏性结膜炎的临床研究
唐红燕	宁波市第二医院眼病中心	中国中医眼科杂志	翼状胬肉切除联合改良滑行结膜瓣移植术的疗效观察
唐红霞	江苏省通州市第三人民医院	临床眼科杂志	康宁克通-A球结膜下注射治疗春季卡他性结膜炎
唐维强	中国上海第二军医大学附属长海医院眼利	国际眼科杂志	基质金属蛋白酶与角膜病变
唐罗生	中南大学湘雅二医院眼科	中国实用眼科杂志	翼状胬肉的不同术式对创面上皮修复及复发率的影响
唐聪	中国中医科学院广安门医院眼科	中华实验眼科杂志	小梁切除术后上皮植入性结膜囊肿一例
唐莉	四川大学华西医院眼科	国际眼科杂志	成都市767例干部体检眼科疾病构成分析
唐连娟	复旦大学附属华山医院南汇分院眼科	国际眼科杂志	翼状胬肉切除改良术式的临床观察
唐连娟	复旦大学附属华山医院南汇分院眼科	国际眼科杂志	翼状胬肉切除联合球结膜下生物羊膜移植的初步研究
唐静	四川大学华西医院眼科	国际眼科杂志	他克莫司治疗春季卡他性角结膜炎的疗效分析
唐飞	四川大学华西医院眼科	国际眼科杂志	成都市767例干部体检眼科疾病构成分析
商蕴波	中国全国中医白内障医疗中心	国际眼科杂志	返魂草滴眼液治疗细菌性结膜炎的疗效观察
喻京生	湖南中医药大学第一附属医院眼科	中国中医眼科杂志	眼科围手术期的中医药治疗
喻咏	陕西省人民医院眼科	眼外伤职业眼病杂志	翼状胬肉与角膜曲率
喻建锋	南通市第一人民医院眼科	中华实验眼科杂志	纤维蛋白胶在兔眼翼状胬肉自体结膜瓣转移手术中的应用
喻建锋	中国江苏省南通市第一人民医院眼科	国际眼科杂志	不同术式治疗翼状胬肉的疗效分析
喻相林	象山县第一人民医院	眼外伤职业眼病杂志	羊膜联合自体角膜缘干细胞移植治疗复发性翼状胬肉
喻箭	兰州军区临潼疗养院附属医院眼科	国际眼科杂志	Parinaud结膜炎1例
喻谦	成都医学院第一附属医院眼科	国际眼科杂志	人翼状胬肉组织HMG-CoA还原酶和LDL受体基因的表达
喻谦	第二军医大学第一附属医院眼科	中华实验眼科杂志	翼状胬肉发病机制研究进展
喻谦	成都医学院第一附属医院眼科	国际眼科杂志	翼状胬肉不同手术方式的术前术后屈光变化观察
喻长泰	武汉爱尔眼科医院	中华实验眼科杂志	染料木黄酮对翼状胬肉成纤维细胞增殖的抑制作用
国庆锋	山东省莘县眼科医院	中华眼视光学与视觉科学杂志	结膜囊吸吮线虫病五例
国秀菊	山东省莘县眼科医院	中华眼视光学与视觉科学杂志	结膜囊吸吮线虫病五例
国纪林	山东省济南市中心医院眼科	临床眼科杂志	两种方法保存羊膜联合自体角膜缘移植治疗复发性翼状胬肉
夏丽坤	中国医科大学附属盛京医院眼科	国际眼科杂志	蒲地蓝消炎口服液治疗流行性角结膜炎的临床疗效
夏云开	高要市人民医院	眼外伤职业眼病杂志	自体角膜缘干细胞移植术治疗翼状胬肉
夏元	南京大学医学院临床学院南京军区南京总医院眼科	中华实验眼科杂志	激光共焦显微镜与组织病理学对翼状胬肉组织中微血管密度研究的比较
夏光辉	中国河南省扶沟县人民医院眼科	国际眼科杂志	自体角膜缘干细胞联合羊膜移植治疗眼表疾病
夏又春	中国湖北省黄冈市第一人民医院眼科	国际眼科杂志	自体角膜缘干细胞移植联合羊膜移植术治疗复发性翼状胬肉的临床研究
夏多胜	兰州大学第二临床医学院	国际眼科杂志	甘肃省农村小学生沙眼快速评估的初步调查报告
夏志生	湖南省茶陵县湘东铁矿职工医院	临床眼科杂志	唇粘膜移植治疗伴睑球粘连的复发性翼状胬肉
夏旭光	遵义医学院第五附属珠海医院眼科	眼外伤职业眼病杂志	两种翼状胬肉结膜移植手术美容效果观察
夏旭光	遵义医学院第五附属	国际眼科杂志	翼状胬肉上结膜反向移植联合生物羊膜治疗复发性翼状胬肉
夏晓燕	诸城市中医院眼科	中国中医眼科杂志	急性视网膜坏死误诊1例
夏朝霞	中山大学附属第二医院眼科	国际眼科杂志	逆行镊撕法联合3种手术方式预防翼状胬肉复发的疗效分析
夏林	诸暨市红十字医院	眼外伤职业眼病杂志	角膜缘干细胞移植与结膜瓣转位治疗翼状胬肉
夏欢	中国湖北省大冶市人民医院眼科	国际眼科杂志	翼状胬肉切除联合角膜干细胞移植术中两种缝合方法对比研究
夏瑜	华中科技大学同济医学院附属同济医院眼科	中华眼科杂志	糖皮质激素性高眼压患者外周血单个核细胞糖皮质激素受体α和β的表达
夏群	北京医院眼科	中华眼视光学与视觉科学杂志	我国开展角膜塑型术的现状及问题
夏群	北京医院眼科	中华眼科杂志	眼科手术后斜视和复视的临床分析
夏鸿慧	高要市人民医院	眼外伤职业眼病杂志	自体角膜缘干细胞移植术治疗翼状胬肉
多丽荣	中国河北省邯郸市眼科医院	国际眼科杂志	翼状胬肉发病机制及治疗研究进展
奈蒙	通许县人民医院眼科	眼外伤职业眼病杂志	翼状胬肉的几种手术方式及其效果观察
奚翠萍	武汉大学中南医院眼科	中国实用眼科杂志	复发翼状胬肉显微切除联合羊膜及自体角膜缘移植临床分析
奚际马	解放军101医院眼科	临床眼科杂志	自体角膜缘上皮移植联合贝复舒治疗翼状胬肉的疗效观察
姚东伟	浙江省宁波市李惠利医院眼科	眼外伤职业眼病杂志	不同浓度平阳霉素预防翼状胬肉复发的效果
姚东伟	宁波李惠利医院眼科	眼科	翼状胬肉复发与组织病理学的关系
姚军平	武汉科技大学附属天佑医院眼科	国际眼科杂志	翼状胬肉切除联合自体角膜缘干细胞移植与联合羊膜移植的疗效比较
姚勇	中山大学中山眼科中心	中华眼科杂志	干眼患者115例的临床特点分析
姚勇	中山大学眼表疾病研究中心	中国实用眼科杂志	过敏性结膜炎的临床特点
姚小春	江西省宜丰县人民医院五官科	眼外伤职业眼病杂志	角膜异物剔除翼状胬肉切除手术致前房积血一例
姚小萍	深圳市中医院	中国中医眼科杂志	化胬抑复冲剂降低翼状胬肉术后复发率的临床研究
姚明君	云南省个旧市红河州第三人民医院眼科	中国中医眼科杂志	自体角膜缘干细胞移植治疗翼状胬肉216例分析
姚晓明	暨南大学医学院深圳眼科中心、深圳市眼科医院	国际眼科杂志	翼状胬肉成纤维细胞中COX-2的表达及其抑制剂的实验研究
姚晓明	深圳市眼科医院，深圳	眼科	翼状胬肉与角膜散光之间关系的研究
姚晓明	暨南大学医学院附属深圳眼科中心	中华实验眼科杂志	翼状胬肉组织中胶原纤维的病理学改变
姚晓明	暨南大学附属深圳市眼科医院	国际眼科杂志	改良纤维蛋白粘合剂在眼表翼状胬肉手术中的应用
姚晓明	暨南大学附属深圳市眼科医院	中国实用眼科杂志	新生儿急性细菌性结膜炎10年致病菌变迁
姚晓明	中国广东省深圳市眼科医院角膜及眼表疾病科	国际眼科杂志	翼状胬肉术后不同处理方法对创面上皮修复的影响
姚晓明	暨南大学医学院深圳眼科中心深圳市眼科医院	眼外伤职业眼病杂志	白内障合并翼状胬肉两种手术方案的选择
姚晓明	暨南大学附属深圳市眼科医院	眼科	特应性角结膜炎治疗前后共焦显微镜检查二例
姚晓明	深圳市梅沙医院	中国实用眼科杂志	IL-1 α在初发与复发性翼状胬肉中的异常表达
姚晓明	深圳市眼科医院	中华实验眼科杂志	翼状胬肉组织中环氧化酶-2及p21-ras的表达研究
姚晓明	暨南大学附属深圳眼科医院	中国斜视与小儿眼科杂志	新生儿急性细菌性结膜炎病原菌及药物敏感性分析
姚晓明	深圳暨南大学附属深圳市眼科医院	中国斜视与小儿眼科杂志	新生儿淋菌性结膜炎致病菌10年药物敏感性的变迁
姚晓明	深圳眼科医院	眼外伤职业眼病杂志	初发胬肉与复发胬肉中ⅠL-1α和VEGFR-1的表达相关性研究
姚桂芹	双鸭山煤炭总医院	眼外伤职业眼病杂志	人羊膜移植治疗眼表疾病19例临床分析
姚欣淋	安徽省东至县人民医院眼科	中国中医眼科杂志	翼状胬肉两种不同术式疗效比较
姚涛	沈阳何氏眼科医院	中国实用眼科杂志	纤维蛋白胶在翼状胬肉切除联合无缝线羊膜移植术中应用的临床观察
姚祖荣	南通医学院第二附属医院眼科江苏南通	眼科	低温保存人羊膜移植在重建眼表结构中的临床应用
姚祖荣	南通医学院第二附属医院眼科	眼科	单层或多层羊膜移植治疗眼表疾病
姚素芬	香港中文大学联合汕头国际眼科中心	中国中医眼科杂志	中药低温凉雾超声雾化法治疗春季结膜炎疗效观察
姚艳娇	中国福建省福州市第二医院眼科	国际眼科杂志	翼状胬肉的治疗进展
姚辉	中国陕西省渭南市第二医院眼科中心	国际眼科杂志	手术显微镜下翼状胬肉切除联合丝裂霉素C应用98例疗效观察
姚达强	广州医学院第二附属医院眼科	中华眼科杂志	翼状胬肉显微手术方法及其疗效观察
姚达强	广州医学院第二附属医院眼科	中国实用眼科杂志	翼状胬肉根治手术预防复发的效果观察
姚运红	广东医学院病理学教研室	国际眼科杂志	翼状胬肉组织中Bcl-2和ICAM-1的表达
姚静艳	苏州大学附属一院眼科	国际眼科杂志	MMP-8在翼状胬肉中的表达
姚静艳	苏州大学附属第一医院眼科	中国实用眼科杂志	MMP-3、MMP-8在翼状胬肉中的表达
姜俊	钦州市第二人民医院	眼外伤职业眼病杂志	羊膜移植治疗难治性眼表疾病的临床效果
姜倩钰	大连市中心医院	眼外伤职业眼病杂志	羊膜移植眼表重建术的临床观察
姜兴华	中国四川省宜宾市第二人民医院眼科	国际眼科杂志	单眼双侧翼状胬肉联合手术临床疗效观察
姜冬玲	华中科技大学附属协和医院眼科	国际眼科杂志	羊膜移植治疗春季角结膜炎的角膜缘病变
姜冬玲	华中科技大学同济医学院附属协和医院眼科	临床眼科杂志	春季角结膜炎角膜缘病变的手术治疗
姜冬玲	华中科技大学同济医学院附属协和医院眼科	中华眼科杂志	春季角结膜炎巨大乳头手术治疗的临床分析
姜冬玲	华中科技大学同济医学院附属协和医院眼科	中华眼科杂志	第15例——双眼疼痛并畏光流泪数日
姜君	温州医学院眼视光学院	中国实用眼科杂志	高透氧性硬性角膜接触镜治疗屈光参差性弱视的疗效评估
姜士军	连云港市第二人民医院眼科	眼外伤职业眼病杂志	海水盐场职工翼状胬肉患病率分析及手术治疗的临床观察
姜士军	中国江苏省连云港市第二人民医院眼科	国际眼科杂志	逆行切除联合自体角膜缘干细胞移植治疗翼状胬肉68例
姜小芬	新晃县人民医院眼科	中国实用眼科杂志	角膜缘干细胞移植和羊膜移植术治疗复发性翼状胬肉临床疗效比较
姜岩	辽宁省本溪市中心医院眼科	中国眼耳鼻喉科杂志	羊膜移植治疗翼状胬肉的临床观察
姜德咏	中南大学湘雅第二医院眼科	中华眼科杂志	自体角膜缘上皮移植术治疗翼状胬肉的临床分析
姜德咏	中南大学湘雅二医院眼科	中国实用眼科杂志	翼状胬肉的不同术式对创面上皮修复及复发率的影响
姜文浩	深圳市龙岗中心医院眼科	眼外伤职业眼病杂志	翼状胬肉手术中羊膜移植与自体角膜缘干细胞移植的效果对比
姜方义	浙江省江山市中医院眼科	中国实用眼科杂志	翼状胬肉术中丝裂霉素C的应用
姜方正	浙江江山眼科医院	眼科	新鲜羊膜移植在重建健康眼表面中的应用
姜楠	青岛大学医学院附属医院眼科	中国实用眼科杂志	人工泪液与重组人表皮生长因子衍生物眼液对翼状胬肉术后干眼疗效观察
姜涛	青岛大学医学院附院	眼外伤职业眼病杂志	翼状胬肉术中应用丝裂霉素C预防复发的观察
姜登旗	重庆三峡中心医院眼科	国际眼科杂志	翼状胬肉切除联合丝裂霉素C及羊膜移植
姜红霞	宁夏石嘴山市第二人民医院眼科	眼科	荧光素钠染色条致双眼角结膜过敏一例
姬亚洲	安阳市眼科医院	眼外伤职业眼病杂志	羊膜移植在翼状胬肉手术中的应用
姬亚洲	河南省安阳市眼科医院	中华实验眼科杂志	白内障术后患者免疫学检测
孔丽萍	温州医学院附属第一医院眼科	临床眼科杂志	自体角膜缘上皮移植术联合羊膜移植术治疗复发性翼状胬肉的临床分析
孔伟	中国湖北省武汉市第十一医院眼科	国际眼科杂志	新鲜羊膜联合自体角膜缘移植治疗复发性翼状胬肉的疗效分析
孔军	中国人民解放军第273医院眼科，库尔勒	中国中医眼科杂志	巴音郭楞蒙古自治州5县市翼状胬肉患病率的调查
孔凡宏	中国北京市通州区潞河医院眼科	国际眼科杂志	显微镜下自体角膜缘干细胞移植治疗翼状胬肉
孔巧	宁波李惠利医院眼科	眼科	翼状胬肉复发与组织病理学的关系
孔巧	浙江省宁波市李惠利医院眼科	眼外伤职业眼病杂志	不同浓度平阳霉素预防翼状胬肉复发的效果
孔巧	浙江宁波李惠利医院眼科	中国实用眼科杂志	塑料薄膜在翼状胬肉手术中的应用
孔庆健	中国上海市松江区中心医院眼科	国际眼科杂志	翼状胬肉基质金属蛋白酶表达的意义
孔庆健	上海交通大学附属第一人民医院松江分院	国际眼科杂志	改良性带蒂结膜瓣移植治疗翼状胬肉的疗效观察
孔庆兰	青岛大学医学院附属医院眼科	国际眼科杂志	复发性翼状胬肉的治疗分析
孔怡淳	天津医科大学	中国中医眼科杂志	睑角结膜炎病例临床表现及疗效分析
孔怡淳	天津眼科医院	中国中医眼科杂志	眼酒糟鼻57例临床观察
孔新萍	内蒙古医学院第三附属医院眼科	临床眼科杂志	人羊膜移植治疗翼状胬肉的临床观察
孔祥峰	中国山东省邹城市人民医院眼科	国际眼科杂志	大范围切除联合新鲜羊膜移植治疗复发性翼状胬肉
孙丰源	天津市第一中心医院眼科	中国实用眼科杂志	重视眼科影像学检查提高临床诊断率
孙丽红	牡丹江医学院红旗医院眼病中心	眼外伤职业眼病杂志	翼状胬肉术后角膜穿孔一例
孙云岭	淮南新华医院集团新华医院眼科	临床眼科杂志	淮南市煤矿工人翼状胬肉患病率的流行病学调查
孙亮亮	浙江省舟山市普陀人民医院眼科	中国中医眼科杂志	翼状胬肉切除术后辅用中药的疗效观察
孙兰萍	邯郸眼科医院眼科	国际眼科杂志	应用准分子激光角膜切削术治疗翼状胬肉的临床观察
孙兰萍	中国河北省邯郸市眼科医院	国际眼科杂志	翼状胬肉手术治疗研究进展
孙兰萍	河北邯郸市眼科医院眼科	中国实用眼科杂志	翼状胬肉切除联合准分子激光治疗性角膜切削术与角膜缘干细胞移植术疗效对比观察
孙兴怀	复旦大学附属眼耳鼻喉科医院眼科	中华眼科杂志	激光共聚焦显微镜观察春季角结膜炎患者的角膜形态变化
孙兴怀	复旦大学附属眼耳鼻喉科医院眼科	中华眼科杂志	加替沙星和左氧氟沙星治疗细菌性结膜炎的疗效对比研究
孙兴怀	复旦大学附属眼耳鼻喉科医院眼科	中国实用眼科杂志	富马酸酮替芬滴眼液治疗季节变应性结膜炎眼痒及结膜充血的疗效观察
孙兴怀	上海复旦大学附属眼耳鼻喉科医院	中国实用眼科杂志	过敏性结膜炎的临床特点
孙凤海	天津市渤海石油医院眼科	眼外伤职业眼病杂志	带蒂球结膜与角膜缘上皮移植治疗翼状胬肉
孙凤海	中国海洋石油总医院眼科	国际眼科杂志	老年性上睑皮肤松垂及睑内翻矫正术
孙凤海	海洋石油总医院眼科	国际眼科杂志	可吸收缝线固定移位带角膜缘干细胞结膜瓣术治疗原发性翼状胬肉
孙凤海	渤海石油职工医院眼科	国际眼科杂志	应用雾化疗法治疗流行性出血性角结膜炎临床观察
孙则红	河北省沧州市中心医院眼科功能检查室	中国斜视与小儿眼科杂志	420例儿童干眼的相关因素分析
孙厚壮	山东省荣成市人民医院眼科	临床眼科杂志	荣成市渔民翼状胬肉的流行病学调查
孙国强	中国医学科学院信息中心	眼科	过敏性结膜炎的流行病学及奥洛他定滴眼液开放性多中心治疗的初步效果
孙国花	威海市文登中心医院	眼外伤职业眼病杂志	结膜囊异物误诊一例
孙宪丽	北京市眼科研究所	眼科	翼状胬肉组织病理学研究及相关因子的检测
孙小婷	同济大学附属同济医院眼科	眼外伤职业眼病杂志	前段光学相干断层成像测量翼状胬肉术后结膜植片厚度的临床研究
孙岩	中国医科大学附属第四医院眼科	国际眼科杂志	两种不同术式治疗翼状胬肉的疗效比较
孙岩	辽宁彰武县人民医院眼科	中国实用眼科杂志	翼状胬肉切除加相邻带干细胞自体结膜转位术疗效观察
孙常峰	河北省张家口市眼科医院	中华实验眼科杂志	自体角膜缘干细胞移植术治疗翼状胬肉421眼临床观察
孙广莉	华中科技大学同济医学院附属协和医院眼科	国际眼科杂志	粉防己碱对翼状胬肉成纤维细胞增生作用的研究
孙康	广东省佛山市第二人民医院眼科	临床眼科杂志	85例眼红斑痤疮临床分析
孙志敏	南通市第一人民医院眼科	中华实验眼科杂志	纤维蛋白胶在兔眼翼状胬肉自体结膜瓣转移手术中的应用
孙慧敏	天津医科大学眼科中心	中国实用眼科杂志	人工角膜的新发展与新模型的临床评估
孙敬雯	解放军273医院眼科	临床眼科杂志	逆行翼状胬肉切除法与顺行切除法对比分析
孙斌	湖北医药学院附属太和医院眼科	临床眼科杂志	翼状胬肉手术前后对比敏感度和角膜地形图改变的比较
孙旭光	北京市眼科学与视觉科学重点实验室	中华眼科杂志	重视我国沙眼的防治工作
孙旭光	首都医科大学附属北京同仁医院眼科中心	眼科	病原学的深入研究是全面提高感染性眼病诊疗水平之关键
孙旭光	北京市眼科学与视觉科学重点实验室	中华眼科杂志	上方角膜缘角结膜炎一例
孙旭光	北京市眼科研究所	中国实用眼科杂志	Nd:YAG激光光凝治疗角膜浅表新生血管
孙旭光	首都医科大学附属同仁医院	中华实验眼科杂志	武强县小学生沙眼流行病学调查
孙旭光	首都医科大学附属北京同仁医院眼科中心	眼科	沙眼患者临床与实验室诊断研究
孙旭光	首都医科大学北京同仁眼科中心	中华眼科杂志	眼局部抗过敏药物的临床应用
孙旭光	同仁眼科中心北京市眼科研究所	中华实验眼科杂志	我国北方两地区小学生沙眼衣原体检测及基因分型研究
孙旭光	北京市眼科学与视觉科学重点实验室	中华实验眼科杂志	沙眼患者病原体基因型的鉴定分析
孙旭光	首都医科大学附属北京同仁医院北京同仁眼科中心	中华眼科杂志	沙眼流行情况的研究进展
孙旭光	北京市眼科研究所微生物室	中华眼视光学与视觉科学杂志	44例真菌性角结膜炎患者真菌培养及药敏试验结果分析
孙时英	兰州军区乌鲁木齐总医院	中华实验眼科杂志	沙眼衣原体两种基因诊断方法的比较
孙时英	兰州军区乌鲁木齐总医院眼科	中华实验眼科杂志	维汉民族中学生沙眼衣原体感染调查
孙时英	兰州军区乌鲁木齐总医院眼科	中华实验眼科杂志	倍诺喜滴眼液致双眼严重角膜损害一例
孙明	中国湖北省大冶市人民医院眼科	国际眼科杂志	角膜接触镜在翼状胬肉切除术的应用评价
孙明霞	中山大学中山眼科中心	中华眼科杂志	移植物抗宿主病相关的干眼病
孙明霞	中山大学中山眼科中心	中国实用眼科杂志	FK506局部治疗顽固性春季角结膜炎
孙晓兰	承德医学院附属医院眼科	中国斜视与小儿眼科杂志	42例新生儿淋菌性结膜炎治疗
孙晓香	济宁医学院附属金乡医院	眼外伤职业眼病杂志	自体角膜缘干细胞移植治疗翼状胬肉
孙景莹	上海大华医院眼科	中国实用眼科杂志	532激光治疗早期翼状胬肉的临床观察
孙晶	龙口市人民医院眼科	中国中医眼科杂志	翼状胬肉术后复发的早期临床表现——角膜上皮修复不良
孙智勇	天津医科大学总医院眼科	中华眼视光学与视觉科学杂志	丝裂霉素C局部贴敷辅助自体角膜缘结膜移植术治疗翼状胬肉
孙松	无锡市第二人民医院眼科	中华实验眼科杂志	人乳头状瘤病毒在翼状胬肉发病机制中的作用
孙松	无锡市第二人民医院眼科	中国实用眼科杂志	肉眼下翼状胬肉切除联合自体角膜缘干细胞移植临床分析
孙永彪	丹阳市儿童医院	眼外伤职业眼病杂志	单纯性翼状胬肉两种手术方法的疗效比较
孙洁	首都医科大学附属北京同仁医院眼科中心	国际眼科杂志	精神压力与心因性结膜炎58例的心理治疗
孙洪然	诸城市中医院眼科	中国中医眼科杂志	急性视网膜坏死误诊1例
孙济民	丹阳市眼病医院	眼外伤职业眼病杂志	单纯性翼状胬肉两种手术方法的疗效比较
孙涛	江苏省盐城市第一人民医院眼科	临床眼科杂志	自体角膜缘干细胞移植术治疗复发性翼状胬肉
孙炜	河北职工医学院病理生理教研室	中华实验眼科杂志	术中应用丝裂霉素C治疗翼状胬肉实验和临床研究
孙烨	陕西省人民医院眼科	中国实用眼科杂志	下泪小点息肉致长期泪溢二例
孙熠	驻香港部队医院眼科	国际眼科杂志	驻港部队海军和陆军战士眼部情况的对比分析
孙玉珍	沈阳二四二医院检验科	中国实用眼科杂志	放线菌性泪小管炎的诊断和治疗
孙玉荣	山东省单县中心医院眼科	中华眼视光学与视觉科学杂志	成年人淋菌性角膜溃疡一例
孙玮玮	中国上海市松江区中心医院眼科	国际眼科杂志	翼状胬肉基质金属蛋白酶表达的意义
孙琴	南通大学附属海安医院眼科	眼外伤职业眼病杂志	复明工程中白内障合并翼状胬肉联合手术
孙瑞芳	乌兰察布市中心医院	眼外伤职业眼病杂志	自体角膜缘干细胞移植治疗翼状胬肉疗效观察
孙由芹	徐州矿务集团第二医院眼科	国际眼科杂志	急性闭角型青光眼误诊分析
孙由芹	徐州矿务集团第二医院眼科	国际眼科杂志	转化生长因子-β与翼状胬肉
孙由芹	徐州矿务集团第二医院眼科	国际眼科杂志	分层剥离手术治疗翼状胬肉
孙秀丽	山东省眼科医院	中华眼视光学与视觉科学杂志	联合或不联合板层角膜移植的结膜瓣移植治疗巩膜坏死
孙秉基	河南省眼科研究所	中国实用眼科杂志	过敏性结膜炎的临床特点
孙秉基	河南省眼科研究所	中华实验眼科杂志	人羊膜联合自体角膜缘移植治疗复发性翼状胬肉
孙秉基	河南省人民医院眼科研究所	眼外伤职业眼病杂志	自体角膜缘上皮移植术治疗翼状胬肉的临床报告
孙秉基	河南省眼科研究所郑州	中华实验眼科杂志	羊膜移植术在治疗大泡性角膜病变中的应用价值
孙秋媛	中国黑龙江省牡丹江市第二人民医院眼科	国际眼科杂志	丝裂霉素C在翼状胬肉切除术中应用
孙立新	湖南省常德市第一人民医院眼科	眼外伤职业眼病杂志	羊膜及角膜缘上皮移植术治疗复发性翼状胬肉
孙红梅	清华大学第一附属医院眼科	国际眼科杂志	自体角膜缘干细胞移植联合丝裂霉素C治疗活动期翼状胬肉
孙美华	河北省沧州市运河区眼科医院	眼外伤职业眼病杂志	翼状胬肉术中应用丝裂霉素C的临床观察
孙群林	解放军第四五四医院眼科	眼外伤职业眼病杂志	睑球粘连分离术中应用丝裂霉素C的临床观察
孙英	上海交通大学附属第九人民医院眼科	临床眼科杂志	改良角膜缘干细胞移植术治疗翼状胬肉的临床观察
孙荣	湖北医药学院附属太和医院眼科	临床眼科杂志	翼状胬肉手术前后对比敏感度和角膜地形图改变的比较
孙葆忱	首都医科大学附属北京同仁医院	眼科	北京市城乡限定人群白内障手术负荷量及术后视力评价
孙葆忱	首都医科大学北京同仁眼科中心	中华眼科杂志	北京特定地区翼状胬肉患病率的流行病学调查
孙轶军	秦皇岛市第一医院	眼外伤职业眼病杂志	带角膜上皮自体角膜缘干细胞治疗翼状胬肉
孙金凤	中国山东省烟台市	国际眼科杂志	羊膜移植在治疗眼表疾病的临床应用
孙金明	中山大学附属第五医院眼科	中国眼耳鼻喉科杂志	翼状胬肉切除术联合丝裂霉素与角膜缘上皮移植的疗效观察
孙靖	天津医科大学眼科中心	中国实用眼科杂志	表层巩膜炎合并复发性多发软骨炎1例
孙静波	解放军第五医院	眼外伤职业眼病杂志	羊膜移植治疗眼表疾病临床观察
孙静芬	上海第二医科大学附属瑞金医院眼科	眼外伤职业眼病杂志	翼状胬肉术中丝裂霉素不同留置时间的效果
孙静辉	浙江省宁海县第一医院眼科	中国眼耳鼻喉科杂志	两种手术方式对翼状胬肉的疗效
孟丹	四川大学华西医院眼科	中华实验眼科杂志	翼状胬肉切除术后继发巨大炎性肉芽肿一例
孟丹	四川大学华西医院眼科	中国实用眼科杂志	双眼Stevens-Johnson综合征误诊1例
孟宪娴	山西省眼科医院	临床眼科杂志	瞬目频繁患儿病因分析
孟宪虎	长春八一医院	眼外伤职业眼病杂志	原发性翼状胬肉手术时机临床观察
孟彤柏	沈阳军区总医院眼科	中国实用眼科杂志	三重眼表解剖屏障重建术防治翼状胬肉复发四年前瞻性研究
孟晶	暨南大学附属第一医院眼科	中国实用眼科杂志	联合颞部注射治疗急性细菌结膜炎
孟晶	暨南大学附属第一医院眼科	中国实用眼科杂志	曲安奈德治疗复发性翼状胬肉24例疗效观察
孟然	中国沈阳铁路中心医院眼科	国际眼科杂志	丝裂霉素C在翼状胬肉转移术中的应用
孟秀文	陕西省汉中市人民医院眼科	眼外伤职业眼病杂志	自体角膜缘上皮移植治疗翼状胬肉
孟青青	中国中医科学院眼科医院	中国中医眼科杂志	过敏性结膜炎的治疗研究进展
季杰	山东省新泰市人民医院眼科	中国眼耳鼻喉科杂志	显微镜下游离结膜移植术治疗翼状胬肉
季杰	山东省新泰市人民医院眼科	中国眼耳鼻喉科杂志	游离结膜移植术治疗翼状胬肉疗效观察
孫鳳海	中國天津市渤海石油公司職工醫院眼科，	国际眼科杂志	帶蒂球結膜與角膜緣上皮移植治療翼狀胬肉
宁晓玲	山西省眼科医院	临床眼科杂志	瞬目频繁患儿病因分析
安建斌	河北医科大学第二医院眼科	中国中医眼科杂志	姜黄素的药理作用及其在眼科的应用研究进展
安德祥	连云港市第二人民医院眼科	眼外伤职业眼病杂志	海水盐场职工翼状胬肉患病率分析及手术治疗的临床观察
安美霞	南方医科大学第三附属医院眼科	国际眼科杂志	汉防己甲素体外对正常结膜与翼状胬肉成纤维细胞抑制作用的比较
安美霞	广东省中山市小榄人民医院眼科	中国实用眼科杂志	正常球结膜与翼状胬肉成纤维细胞生长增殖状况的对比观察
安美霞	中国广东省中山市小榄人民医院眼科	国际眼科杂志	汉防己甲素对翼状胬肉成纤维细胞基质金属蛋白酶的影响
安美霞	中山大学中山眼科中心中山大学眼科学国家重点实验室	国际眼科杂志	汉防己甲素抑制翼状胬肉成纤维细胞增殖的研究
安美霞	中国广东省中山市小榄人民医院眼科	国际眼科杂志	β-catenin在翼状胬肉成纤维细胞中的表达
安美霞	中山大学中山眼科中心	中华实验眼科杂志	汉防己甲素对翼状胬肉成纤维细胞抑制作用的实验研究
安美霞	南方医科大学第三附属医院眼科	中国中医眼科杂志	初复发翼状胬肉相关因子检测及汉防己甲素作用观察
安良香	山东省日照市人民医院眼科	中国眼耳鼻喉科杂志	带环形巩膜瓣全角膜板层移植术治疗角膜表面衰竭
安良香	山东省日照市人民医院眼科	临床眼科杂志	带环形巩膜瓣及角膜缘的全角膜板层移植术治疗蚕蚀性角膜溃疡
宋书华	中山大学中山眼科中心	中国实用眼科杂志	翼状胬肉切除对泪液功能的影响
宋剑涛	中国中医科学院眼科医院	中国中医眼科杂志	过敏性结膜炎的治疗研究进展
宋剑涛	中国中医科学院眼科医院	中国中医眼科杂志	川椒方治疗过敏性结膜炎的临床观察
宋君胜	安徽省东至县人民医院眼科	中国中医眼科杂志	翼状胬肉两种不同术式疗效比较
宋国奇	郏县人民医院	眼外伤职业眼病杂志	逆行切除联合球结膜移植治疗翼状胬肉
宋国训	即墨市第二人民医院	眼外伤职业眼病杂志	翼状胬肉术中应用丝裂霉素C预防复发的观察
宋宙光	潍坊眼科医院	临床眼科杂志	角膜磨削联合角膜缘干细胞移植术治疗翼状胬肉疗效观察
宋寅伟	武汉大学中南医院眼科	国际眼科杂志	综合治疗复发性翼状胬肉疗效观察
宋寅伟	武汉大学中南医院眼科	中华实验眼科杂志	翼状胬肉新生血管形成机制及其治疗的研究进展
宋寅伟	武汉大学中南医院眼科	国际眼科杂志	羊膜移植联合丝裂霉素C治疗翼状胬肉的Meta分析
宋峰伟	湖州师范学院附属第一医院眼科	国际眼科杂志	翼状胬肉术后角膜屈光状态稳定时间的临床观察
宋愈	南通医学院第二附属医院眼科江苏南通	眼科	低温保存人羊膜移植在重建眼表结构中的临床应用
宋愈	南通市第一人民医院眼科	中华实验眼科杂志	纤维蛋白胶在兔眼翼状胬肉自体结膜瓣转移手术中的应用
宋愈	中国江苏省南通市第一人民医院眼科	国际眼科杂志	不同术式治疗翼状胬肉的疗效分析
宋愈	南通医学院第二附属医院眼科	眼科	单层或多层羊膜移植治疗眼表疾病
宋慧	天津医科大学眼科中心	中国实用眼科杂志	人工角膜的新发展与新模型的临床评估
宋扬	中国吉林省梨树县中医院眼科	国际眼科杂志	返魂草滴眼液治疗细菌性结膜炎的疗效观察
宋斗	解放军第117医院眼科	眼外伤职业眼病杂志	颅底骨折右眼眶骨折并颈动脉海绵窦瘘一例
宋新华	河南省安阳市眼科医院	中华实验眼科杂志	白内障术后患者免疫学检测
宋新华	安阳市眼科医院	眼外伤职业眼病杂志	羊膜移植在翼状胬肉手术中的应用
宋晏平	中国福建省宁德市医院眼科	国际眼科杂志	羊膜移植与结膜移植治疗翼状胬肉的比较
宋晏平	宁德市医院	眼外伤职业眼病杂志	羊膜移植在翼状胬肉术中的应用
宋曙	江苏省盐城市第一人民医院病理科	临床眼科杂志	自体角膜缘干细胞移植术治疗复发性翼状胬肉
宋曙光	江苏省淮安市第一人民医院眼科	临床眼科杂志	自体上方球结膜瓣转位治疗翼状胬肉疗效观察
宋玉伟	中国四川省宜宾市第二人民医院眼科	国际眼科杂志	单眼双侧翼状胬肉联合手术临床疗效观察
宋玉萍	山西医科大学附属晋中市第一人民医院眼科	中国眼耳鼻喉科杂志	自体角膜缘组织移植治疗翼状胬肉的临床体会
宋秀胜	中国湖北省恩施州中心医院眼科	国际眼科杂志	自体角膜缘干细胞移植联合MMC对翼状胬肉疗效的Meta分析
宋艳玲	山东省东营市人民医院	中国中医眼科杂志	翼状胬肉钝性剥离联合纤维蛋白胶固定自体角膜缘干细胞移植术的临床应用
宋蓓雯	上海交通大学附属第六人民医院眼科	临床眼科杂志	脉络膜黑色素瘤误诊为视网膜脱离1例
宋蓓雯	上海交通大学附属第六人民医院眼科	中华实验眼科杂志	翼状胬肉胶原变化的研究
宋邦伟	滨海县人民医院	眼外伤职业眼病杂志	翼状胬肉撕离联合不同角膜缘干细胞移植
宋金鑫	中国陕西省西安市第一医院眼科	国际眼科杂志	原发性翼状胬肉与干眼关系的临床观察
宋钰	山东威海市文登中心医院	中国实用眼科杂志	结核性眼炎误诊为眼内肿瘤一例
宋钰	山东省威海市文登中心医院眼科	中国眼耳鼻喉科杂志	文登沿海乡镇中老年翼状胬肉的流行病学特点
宋青山	中国广东省惠州市中心人民医院眼科	国际眼科杂志	翼状胬肉切除联合带自体角膜缘干细胞的结膜移植治疗复发性翼状胬肉
宫媛媛	上海交通大学附属第一人民医院眼科	中华实验眼科杂志	视网膜脱离术后植入物外露致低眼压一例
宫斌	淮南新华医院集团新华医院眼科	临床眼科杂志	淮南市煤矿工人翼状胬肉患病率的流行病学调查
容占其	武城县中医院	眼外伤职业眼病杂志	复发性翼状胬肉的综合治疗及临床观察
寇兴斌	禹州市人民医院	眼外伤职业眼病杂志	改良自体角膜干细胞移植术治疗翼状胬肉初步观察
尚崇学	云南省红十字会医院眼科	眼外伤职业眼病杂志	空气中的污染物致翼状胬肉的职业流行病学调查报告
尚扬	三峡大学仁和医院眼科	中国中医眼科杂志	羊膜移植治疗翼状胬肉的整体护理
尚玉堂	解放军59中心医院眼科	临床眼科杂志	四头带加压致角膜后弹力层断裂2例
尚玲	云南省文山州中医院眼科，云南	中国中医眼科杂志	里光洗眼液治疗急性卡他性结膜炎疗效观察
尤雅丽	福建省石狮市医院眼耳鼻喉科	中国眼耳鼻喉科杂志	自体角膜缘上皮结膜组织瓣移植术治疗翼状胬肉60例
尹万昕	长春八一医院	眼外伤职业眼病杂志	原发性翼状胬肉手术时机临床观察
尹东明	广东省人民医院眼科	中华眼科杂志	移植物抗宿主病相关的干眼病
尹东明	广东省人民医院眼科	中华实验眼科杂志	造血干细胞移植术后的眼部观察
尹丽婷	河南省鹤壁市鹤煤集团总医院眼科	临床眼科杂志	曲安奈德与丝裂霉素C在不同翼状胬肉切除术后应用的疗效观察
尹兴昌	武警青海总队医院检验科	临床眼科杂志	沙眼衣原体与沙眼的研究进展
尹峥	遵义医学院第五附属珠海医院眼科	眼外伤职业眼病杂志	两种翼状胬肉结膜移植手术美容效果观察
尹峥	遵义医学院第五附属	国际眼科杂志	翼状胬肉上结膜反向移植联合生物羊膜治疗复发性翼状胬肉
尹忠贵	中国上海市浦东新区人民医院眼科	国际眼科杂志	自体角膜缘干细胞移植和自体游离球结膜移植治疗翼状胬肉的疗效观察
尹玉存	中国内蒙古乌兰浩特市医院眼科	国际眼科杂志	特发性持续性眼睑痉挛1例
尹翠云	安徽省马鞍山市马钢医院眼科	临床眼科杂志	羊膜移植治疗翼状胬肉临床疗效观察
尹艳辉	永州市眼科研究所	眼外伤职业眼病杂志	翼状胬肉术后滴用重组人表皮生长因子的疗效
尹莉莉	江苏省南京市中医院眼科	眼科	滴用盐酸奥布卡因引起一过性瞳孔散大三例
尹鸿燕	克拉玛依市中心医院眼科	中国实用眼科杂志	准分子激光角膜上皮瓣下磨镶术治疗角膜浅层病变观察
屠叔丹	浙江绍兴文理学院附属医院眼科	中国实用眼科杂志	加替沙星滴眼液治疗细菌性结膜炎临床分析
岑志敏	广东省中山火炬开发区医院眼科	国际眼科杂志	不同手术方式对翼状胬肉患者泪液功能的影响
岳以英	天津眼科医院	中国中医眼科杂志	睑角结膜炎病例临床表现及疗效分析
岳军	湖北省三峡学院医学院附属医院眼科	眼科	羊膜移植治疗翼状胬肉的临床应用
岳军	三峡大学医学院附属医院，湖北宜昌	眼科	羊膜移植治疗大泡性角膜病变的临床应用
岳章显	华中科技大学同济医学院附属孝感医院眼科	国际眼科杂志	深部固定术治疗先天性内翻倒睫的临床观察
岳章显	华中科技大学同济医学院附属孝感医院眼科	国际眼科杂志	角膜缘干细胞移植及羊膜移植联合丝裂霉素C治疗复发性翼状胬肉
岳红云	兰州军区兰州总医院肿瘤科	中国斜视与小儿眼科杂志	重度春季角结膜炎一例
岳红云	兰州军区兰州总医院眼科中心	中华眼科杂志	翼状胬肉切除联合结膜自体移植术中纤维蛋白胶应用的Meta分析
岳辉	中国湖南省长沙市第四医院眼科	国际眼科杂志	角膜缘干细胞移植联合羊膜移植治疗翼状胬肉
岳辉	中国湖南省长沙市第四医院眼科	国际眼科杂志	两种不同翼状胬肉手术方式对角膜屈光的影响
崔伟	益阳医学高等专科学校附属医院眼科	国际眼科杂志	不同翼状胬肉手术方式对角膜屈光的影响
崔冬梅	清华大学第一附属医院眼科	国际眼科杂志	自体角膜缘干细胞移植联合丝裂霉素C治疗活动期翼状胬肉
崔华	江西省人民医院眼科	中国实用眼科杂志	保存人羊膜移植治疗难治性眼表疾病的临床效果
崔巍	中国内蒙古自治区呼和浩特市	国际眼科杂志	沙眼诊断和治疗的研究进展
崔巍	内蒙古科技大学第一附属医院眼科	中华实验眼科杂志	内蒙古赤峰市克什克腾旗中小学生沙眼流行病学调查
崔幼侠	辽宁抚顺眼病医院	中国实用眼科杂志	冻干人羊膜治疗翼状胬肉的临床观察
崔建萍	中国江苏省徐州市第一人民医院眼科	国际眼科杂志	不同术式治疗翼状胬肉的疗效观察
崔彤彤	首都医科大学附属北京同仁医院	眼科	北京市城乡限定人群白内障手术负荷量及术后视力评价
崔彤彤	首都医科大学附属北京同仁医院跟科中心北京市眼科研究所	眼科	北京农村老年居民翼状胬肉患病情况分析
崔敏	四川大学附属华西医院眼科	中国实用眼科杂志	过敏性结膜炎的临床特点
崔敏政	福建省龙岩市人民医院眼科	临床眼科杂志	眼部带状疱疹24例临床观察
崔月丽	山东省青岛市青岛疗养院眼科	国际眼科杂志	自体角膜缘上皮移植和羊膜移植治疗翼状胬肉107例
崔波	山东省东营市人民医院	中国中医眼科杂志	翼状胬肉钝性剥离联合纤维蛋白胶固定自体角膜缘干细胞移植术的临床应用
崔波	东营市人民医院	眼外伤职业眼病杂志	纤维蛋白胶在翼状胬肉切除联合自体角膜缘干细胞移植术中的应用研究
崔燕辉	首都医科大学附属北京儿童医院眼科	中华实验眼科杂志	先天性阔睑一例
崔瑞	河南省漯河市第三人民医院	眼外伤职业眼病杂志	自体角膜缘移植治疗复发性翼状胬肉
崔秀成	承德医学院附属医院	眼科	干眼症患病因素的临床分析
崔红波	浙江宁波李惠利医院眼科	中国实用眼科杂志	塑料薄膜在翼状胬肉手术中的应用
崔红波	浙江省宁波市李惠利医院眼科	眼外伤职业眼病杂志	不同浓度平阳霉素预防翼状胬肉复发的效果
崔红波	宁波李惠利医院眼科	眼科	翼状胬肉复发与组织病理学的关系
左宏宇	中国湖北省黄石市大冶有色金属公司	国际眼科杂志	电焊弧光引起角、结膜改变的临床观察
左文渊	中国山西大同市解放军第322医院眼科	国际眼科杂志	新鲜羊膜移植与自体球结膜移植治疗翼状胬肉的临床观察
左玉洁	郸城县中医院	眼外伤职业眼病杂志	眶内非金属异物误诊原因分析及防止措施
左继东	广水市第一人民医院	眼外伤职业眼病杂志	三联疗法治疗翼状胬肉
巫宇舟	中国江苏省昆山市第一人民医院	国际眼科杂志	VEGF、CD34、Ki-67和p21在翼状胬肉中的表达及意义
席兴华	中南大学湘雅二医院眼科	国际眼科杂志	翼状胬肉发病机制的分子生物学研究进展
席兴华	中南大学湘雅二医院眼科	中国实用眼科杂志	翼状胬肉的不同术式对创面上皮修复及复发率的影响
席祖莲	湖北省宜昌市夷陵医院眼科	中国眼耳鼻喉科杂志	氟康唑联合聚维酮碘治疗真菌性结膜炎
常万松	武警河南总队卫生处	中华实验眼科杂志	沙眼衣原体两种基因诊断方法的比较
常丽璟	南京医科大学附属南京第一医院眼科	国际眼科杂志	翼状胬肉切除术前与术后角膜变化的研究
常佩香	延安大学附属医院眼科	国际眼科杂志	复发性翼状胬肉切除联合自体角膜缘上皮移植的疗效分析
常宝琴	西安市中心医院眼科	临床眼科杂志	角膜缘干细胞移植联合丝裂霉素C应用对抑制翼状胬肉复发的初步观察
常宝琴	西安市中心医院眼科	临床眼科杂志	角膜缘干细胞移植加丝裂霉素C棉片浸放与新鲜羊膜移植治疗翼状胬肉的对比观察
常明龙	中国陕西省榆林市第二医院眼科	国际眼科杂志	新鲜羊膜移植治疗眼表疾病89例
常艳	伊犁哈萨克自治州中医医院中西医眼病中心	中国中医眼科杂志	自体角膜缘干细胞结膜移植治疗翼状胬肉
常莉	河南省安阳市眼科医院	中华实验眼科杂志	白内障术后患者免疫学检测
常青	中国陕西省西安市第一医院眼科	国际眼科杂志	翼状胬肉在激光共焦显微镜下的观察研究
常鲁华	山东省荣成市人民医院眼科	临床眼科杂志	荣成市渔民翼状胬肉的流行病学调查
幸宜春	江西省新余市人民医院眼科	中国眼耳鼻喉科杂志	新鲜羊膜移植治疗睑球粘连的临床观察
庄宏	复旦大学附属眼耳鼻喉科医院眼科	中国眼耳鼻喉科杂志	试题与答案
庄建福	厦门眼科中心	中国斜视与小儿眼科杂志	厦门市思明区3～6岁儿童眼病调查
庄晋峰	深圳市中医院	中国中医眼科杂志	化胬抑复冲剂降低翼状胬肉术后复发率的临床研究
庄绍君	广东省惠东县人民医院眼科	临床眼科杂志	三种不同术式翼状胬肉切除术的临床对比观察
庄铭忠	福建医科大学附属第二医院	眼科	Stevens-Johnson综合征研究现状
庆惠玲	郑州大学医院三院眼科	眼外伤职业眼病杂志	角膜缘干细胞移植治疗复发性胬肉临床分析
应亚坤	浙江省舟山市陆军医院眼科	眼外伤职业眼病杂志	翼状胬肉切除加结膜瓣转位术疗效观察
应方薇	暨南大学附属深圳市眼科医院角膜病科	国际眼科杂志	羊膜移植术治疗重症春季卡他性结膜炎的疗效分析
应飞凤	北京市中关村医院眼科	眼科	90Srβ射线照射预防翼状胬肉术后复发追踪观察
底煜	中国医科大学盛京医院眼科	国际眼科杂志	自体结膜瓣移植治疗翼状胬肉的临床观察
庞东渤	辽宁医学院附属第一医院眼科	国际眼科杂志	玻璃酸钠滴眼液对翼状胬肉转位术后泪膜恢复的作用
庞国祥	中国协和医科大学	中华眼科杂志	瘢痕性类天疱疮眼部病变一例
庞旭	海军总医院眼科	中华眼科杂志	以伪膜性结膜炎为首发表现的水痘一例
庞海涛	甘肃省敦煌市医院	临床眼科杂志	高原地区翼状胬肉显微手术治疗疗效观察
庞琳	邯郸市眼科医院	眼外伤职业眼病杂志	泪道冲洗碘必殊眼膏注入联合按压治疗泪小管炎
庞琳	河北邯郸市眼科医院眼科	中国实用眼科杂志	翼状胬肉切除联合准分子激光治疗性角膜切削术与角膜缘干细胞移植术疗效对比观察
庞福新	河南省兰考县中医院眼科	眼外伤职业眼病杂志	冷冻治疗早期翼状胬肉的临床观察
庞稚菊	天津眼科医院	中国中医眼科杂志	眼酒糟鼻57例临床观察
庞雅菊	天津市眼科医院	中国中医眼科杂志	针刺对Sjogren综合征患者泪液的影响
庞雅菊	天津眼科医院	中国中医眼科杂志	睑角结膜炎病例临床表现及疗效分析
康凯	黑龙江省佳木斯市中心医院眼科	中国眼耳鼻喉科杂志	环氧化酶2在翼状胬肉中的表达及意义
康前雁	西安市第四医院眼科	临床眼科杂志	翼状胬肉切除联合角膜缘干细胞移植术远期疗效分析
康剑书	云南省第二人民医院眼科	国际眼科杂志	明胶酶MMP-2和MMP-9及其组织抑制剂与眼科疾病
康玮	中国中医研究院广安门医院眼科	中国中医眼科杂志	金珠滴眼液治疗慢性结膜炎的临床观察
廖华萍	上海瑞视眼科	国际眼科杂志	高压氧治疗眼科应用进展
廖悦英	高要市人民医院	眼外伤职业眼病杂志	自体角膜缘干细胞移植术治疗翼状胬肉
廖振鸣	湖北省汉川市中医院眼科	中国眼耳鼻喉科杂志	自体角膜缘或结膜移植术预防翼状胬肉复发的临床分析
廖文雄	中山大学第二附属医院眼科	中国实用眼科杂志	翼状胬肉切除结膜移植联合术后90Sr照射的疗效观察
廖瑞端	中山大学附属第一医院眼科	中华眼底病杂志	系统性红斑狼疮并发视网膜静脉阻塞的临床分析
廖荣丰	安徽医科大学附属医院眼科	眼外伤职业眼病杂志	角膜缘上皮联合羊膜移植治疗眼表疾病的研究
延新年	中国陕西省咸阳市第一人民医院眼二科	国际眼科杂志	自体角膜缘干细胞移植联合丝裂霉素治疗翼状胬肉的临床效果
张一凡	秦皇岛市第一医院	眼外伤职业眼病杂志	自体结膜角膜缘上皮移植治疗翼状胬肉临床观察
张一凡	秦皇岛市第一医院	眼外伤职业眼病杂志	带角膜上皮自体角膜缘干细胞治疗翼状胬肉
张东魁	河南省安阳市眼科医院	中华实验眼科杂志	白内障术后患者免疫学检测
张丰菊	大连医科大学附属第一临床学院	中国实用眼科杂志	自体角膜缘结膜移植治疗翼状胬肉
张丽	中国吉林省四平市中心人民医院眼科	国际眼科杂志	骨髓间充质干细胞羊膜片移植治疗翼状胬肉的观察和护理
张丽京	中国南京军区南京总医院眼科	国际眼科杂志	盐酸洛美沙星眼凝胶临床生物等效性试验
张乐	荣成市第二人民医院	眼外伤职业眼病杂志	鱼舱内鳀鱼腐败气体中毒的眼部表现
张云峰	龙口市人民医院眼科	中国中医眼科杂志	翼状胬肉术后复发的早期临床表现——角膜上皮修复不良
张亚娟	中国河北省邯郸市眼科医院	国际眼科杂志	翼状胬肉手术治疗研究进展
张亚娟	邯郸眼科医院眼科	国际眼科杂志	应用准分子激光角膜切削术治疗翼状胬肉的临床观察
张亚娟	河北邯郸市眼科医院眼科	中国实用眼科杂志	翼状胬肉切除联合准分子激光治疗性角膜切削术与角膜缘干细胞移植术疗效对比观察
张亚琳	清华大学第一附属医院眼科	国际眼科杂志	自体角膜缘干细胞移植联合丝裂霉素C治疗活动期翼状胬肉
张亚飞	江苏省如皋市近视眼医院	中华眼视光学与视觉科学杂志	眼表麻醉致急性过敏性结膜炎1例
张亦田	中国广东省大埔县人民医院五官科	国际眼科杂志	翼状胬肉切除法与撕除法术后疼痛的对比研究
张京娜	温州医学院附属眼视光医院	中华实验眼科杂志	Sj(o)gren综合征患者的角膜激光共焦显微镜活体观察
张仕强	宁强县大安镇中心卫生院	中国中医眼科杂志	眼上穹窿部异物2例
张仕强	宁强县大安镇中心卫生院	中国中医眼科杂志	利多卡因表面麻醉致过敏性休克1例
张伟英	上海市同济大学附属东方医院	中国眼耳鼻喉科杂志	翼状胬肉剪除术和传统切除术的临床比较
张伟英	同济大学附属东方医院	中国眼耳鼻喉科杂志	翼状胬肉剪除术的临床疗效观察
张伟英	同济大学附属东方医院	中华眼科杂志	结膜松弛症球结膜组织中热休克蛋白的表达
张传坤	南京军区福州总医院	中国实用眼科杂志	翼状胬肉术后诊断为血友病A一例
张传电	湖南省常德市第一人民医院眼科	眼外伤职业眼病杂志	羊膜及角膜缘上皮移植术治疗复发性翼状胬肉
张俊	泸州医学院附属医院眼科	中国实用眼科杂志	2011年泸州市40岁及以上人群翼状胬肉患病率调查
张俊华	福建中医学院附属人民医院眼科	中国中医眼科杂志	清开灵和干扰素对翼状胬肉成纤维细胞增殖的影响
张俊华	福建省人民医院眼科	中华眼视光学与视觉科学杂志	细胞因子对翼状胬肉成纤维细胞增殖的影响
张俊杰	河南省科研究所	中华实验眼科杂志	复方酮替芬滴眼剂对实验过敏性结膜炎的疗效观察
张俊杰	河南省眼科研究所	中华实验眼科杂志	盐酸左氧氟沙星滴眼液治疗细菌性结膜炎及角膜炎随机双盲对照临床研究
张保夫	山东省德州市人民医院眼科	眼外伤职业眼病杂志	逆行切除联合巩膜裸露区烧灼治疗复发性翼状胬肉
张倩	武警湖北总队医院眼科	眼科	基质金属蛋白酶、凋亡、端粒酶与翼状胬肉
张健	湖南中医药大学第一附属医院中医眼科学重点学科	国际眼科杂志	春季角结膜炎的治疗进展
张健	象山县第一人民医院	眼外伤职业眼病杂志	羊膜联合自体角膜缘干细胞移植治疗复发性翼状胬肉
张健	诸城市中医院眼科	中国中医眼科杂志	急性视网膜坏死误诊1例
张兆岳	福建省闽候县人民医院眼科	眼外伤职业眼病杂志	双裸式结膜桥联合局部注射曲安缩松治疗翼状胬肉
张克军	山西医科大学第一医院耳鼻咽喉科变态反应室	中华眼科杂志	过敏性结膜炎变应原检查
张兰君	西安市第一医院眼病研究室	中华实验眼科杂志	抗腺病毒3型单克隆抗体的制备及临床应用研究
张兰金	河南省安阳市眼科医院	中华实验眼科杂志	白内障术后患者免疫学检测
张兴儒	上海中医药大学附属普陀医院眼科	中华眼科杂志	睑板腺功能异常
张兴儒	上海中医药大学附属普陀医院	中华眼科杂志	结膜松弛症球结膜组织中热休克蛋白的表达
张兴儒	上海中医药大学附属普陀医院眼科	国际眼科杂志	利用OCT观察流行性出血性结膜炎的临床研究
张兴儒	上海中医药大学附属普陀医院眼科	国际眼科杂志	结膜松弛症球结膜成纤维细胞培养的研究
张军	内蒙古自治区人民医院眼科	临床眼科杂志	羊膜移植联合曲安奈德治疗复发性翼状胬肉的临床观察
张冬香	武汉科技大学附属天佑医院	眼外伤职业眼病杂志	风湿病患者双眼翼状胬肉术后发生坏死性巩膜炎
张凌	湖南省常德市第一人民医院眼科	眼外伤职业眼病杂志	羊膜及角膜缘上皮移植术治疗复发性翼状胬肉
张利华	固始县人民医院	眼外伤职业眼病杂志	结膜瓣转移联合低浓度丝裂霉素C治疗翼状胬肉
张前卫	山东省枣庄市立医院眼科	中国眼耳鼻喉科杂志	翼状胬肉切除联合自体结膜移植术疗效观察
张功永	福建省三明市第三医院眼科	中国实用眼科杂志	丝裂霉素C溶液滴眼致巩膜坏死的救治
张劲松	中国医科大学附属第四医院眼科	国际眼科杂志	层黏连蛋白对人翼状胬肉成纤维细胞生长的抑制作用
张勇	郧阳医学院附属太和医院眼科	国际眼科杂志	增殖细胞核抗原和胰岛素样生长因子Ⅱ在翼状胬肉组织中的表达
张勇	北京同仁医院病理科	眼科	翼状胬肉组织病理学研究及相关因子的检测
张勇	郧阳医学院附属太和医院眼科	眼外伤职业眼病杂志	翼状胬肉埋藏法113例
张勤	河南省太康县人民医院眼科	眼外伤职业眼病杂志	自体角膜缘干细胞移植治疗翼状胬肉
张勤	江苏省泰州市高港中医院眼科	中国眼耳鼻喉科杂志	改良胬肉切除加结膜下埋藏术的体会
张卉颖	中山大学眼科学国家重点实验室	中华实验眼科杂志	CD34在翼状胬肉中表达的意义
张华	中国陕西省西安市第四医院眼科	国际眼科杂志	医用生物蛋白胶联合角膜缘干细胞移植在复发性翼状胬肉治疗中的应用
张华茂	湖南省靖州县中医院眼科	中国实用眼科杂志	原发性翼状胬肉的两种手术治疗的疗效比较
张南	北京中医药大学附属东直门医院眼科	中国中医眼科杂志	退赤止痒液治疗春季结膜炎
张南	北京中医药大学东直门医院眼科	中国中医眼科杂志	自体结膜角膜缘干细胞移植术治疗翼状胬肉的临床观察
张卯年	解放军总医院眼科	中国实用眼科杂志	上睑外侧退行性内翻对高龄老年人的影响
张历浊	河北省张家口市第四医院眼科	中国实用眼科杂志	非炎性坏死性巩膜溃疡
张厚丽	中国陕西省安康市中心医院眼科	国际眼科杂志	羊膜移植联合自体角膜缘移植治疗角膜缘功能衰竭症
张厚洪	中国湖北省大冶市人民医院眼科	国际眼科杂志	翼状胬肉切除联合角膜干细胞移植术中两种缝合方法对比研究
张厚洪	中国湖北省大冶市人民医院眼科	国际眼科杂志	角膜接触镜在翼状胬肉切除术的应用评价
张发梁	广西北海市人民医院眼科	中华实验眼科杂志	角膜缘干细胞移植治疗翼状胬肉低复发率手术技巧
张发梁	广西北海市人民医院眼科	中国眼耳鼻喉科杂志	前弹力层撕除联合角膜缘干细胞移植治疗翼状胬肉
张吉福	白山市中心医院眼科	眼外伤职业眼病杂志	环形羊膜缝合联合丝裂霉素治疗翼状胬肉
张君	北京大学第三医院眼科	中华眼科杂志	泪道栓塞术治疗干眼症的临床效果
张哲	首都医科大学北京同仁眼科中心	中华眼科杂志	结膜鳞状细胞癌侵犯眼球内一例
张国刚	沈阳药科大学中药学院	国际眼科杂志	层黏连蛋白对人翼状胬肉成纤维细胞生长的抑制作用
张国安	解放军第476医院临床免疫研究室	中华眼视光学与视觉科学杂志	细胞因子对翼状胬肉成纤维细胞增殖的影响
张国安	中国人民解放军第476医院临床免疫研究室	中国中医眼科杂志	清开灵和干扰素对翼状胬肉成纤维细胞增殖的影响
张士元	首都医科大学附属北京同仁医院	眼科	北京市城乡限定人群白内障手术负荷量及术后视力评价
张士元	首都医科大学北京同仁眼科中心	中华眼科杂志	北京特定地区翼状胬肉患病率的流行病学调查
张士华	广东省惠州市中心人民医院眼科	临床眼科杂志	微量曲安奈德在翼状胬肉术前的临床应用价值
张士胜	上海交通大学医学院附属瑞金医院眼科	国际眼科杂志	高压氧治疗眼科应用进展
张大传	安徽省蒙城县第一人民医院眼科	眼外伤职业眼病杂志	改良泪囊鼻腔吻合术
张大卫	中国北京市通州区潞河医院眼科	国际眼科杂志	显微镜下自体角膜缘干细胞移植治疗翼状胬肉
张妍霞	上海和平眼科医院	中国实用眼科杂志	环孢素A在眼表移植和角膜炎症中的应用
张娟	郸城县中医院	眼外伤职业眼病杂志	眶内非金属异物误诊原因分析及防止措施
张婧	首都医科大学宣武医院眼科	国际眼科杂志	眼科局部用药的毒性反应分析
张婷	中国陕西省宝鸡市中医医院眼科	国际眼科杂志	翼状胬肉病因和治疗与复发干预的临床研究进展
张媛	第二军医大学附属长海医院眼科	国际眼科杂志	转化生长因子β及其受体在翼状胬肉中基因表达的定量检测
张媛梅	承德医学院附属医院	眼科	干眼症患病因素的临床分析
张孝明	重庆医科大学附属第二医院眼屈光中心	中国实用眼科杂志	眼局部用药所致干眼的诊断和治疗
张季瑾	天津大港油田总医院眼科	国际眼科杂志	双氯芬酸钠结合中药熏眼辅助治疗泡性结膜炎的临床观察
张宏	深圳市宝安区人民医院眼科	眼外伤职业眼病杂志	翼状胬肉自体角膜缘干细胞移植术
张宏	中国广东省深圳市宝安区人民医院眼科	国际眼科杂志	Survivin蛋白和Fas蛋白在原发性翼状胬肉中的表达及其相关性研究
张宗端	温州医学院附属眼视光医院	中华眼视光学与视觉科学杂志	翼状胬肉对角膜生物力学特性的影响
张家驎	南宁市红十字会医院眼科	眼外伤职业眼病杂志	羊膜移植治疗翼状胬肉
张小平	解放军第546医院五官科	国际眼科杂志	带角膜缘干细胞结膜瓣移植治疗复发性翼状胬肉
张小平	中国新疆维吾尔自治区乌鲁木齐市	国际眼科杂志	春季卡他性结膜炎患者泪液β2微球蛋白的测定及意义
张小艳	北京市眼科学与视觉科学重点实验室	中华眼科杂志	上方角膜缘角结膜炎一例
张小露	平顶山市第二人民医院	眼外伤职业眼病杂志	自体角膜缘干细胞移植治疗翼状胬肉
张小龙	白银市第一人民医院眼科	眼外伤职业眼病杂志	新鲜羊膜移植治疗翼状胬肉临床观察
张少康	山西芮城县人民医院眼科	眼外伤职业眼病杂志	改良翼状胬肉切除加带蒂结膜移植手术临床总结
张少斌	潍坊眼科医院	临床眼科杂志	角膜磨削联合角膜缘干细胞移植术治疗翼状胬肉疗效观察
张履玉	云南省红河州磷肥厂厂医院	眼外伤职业眼病杂志	空气中的污染物致翼状胬肉的职业流行病学调查报告
张帆	成都医学院第一附属医院眼科	国际眼科杂志	翼状胬肉不同手术方式的术前术后屈光变化观察
张帆	中国新疆维吾尔自治区喀什地区第二人民医院眼科	国际眼科杂志	自体角膜缘干细胞移植治疗维吾尔族翼状胬肉的疗效
张幼梅	郑州大学第一附属医院眼科	眼外伤职业眼病杂志	外伤性眼前段炎症的非甾体抗炎新药--双氯芬酸胆碱滴眼液的研究
张庆莲	中国全国中医白内障医疗中心	国际眼科杂志	返魂草滴眼液治疗细菌性结膜炎的疗效观察
张廷举	山东省威海市立医院眼科	中国眼耳鼻喉科杂志	新生儿泪囊炎的按摩治疗法
张建东	沈阳市爱尔眼视光医院	中国实用眼科杂志	自体角膜缘干细胞移植联合丝裂霉素C治疗翼状胬肉疗效观察
张建华	济南施尔明眼科医院	眼外伤职业眼病杂志	自体角膜缘干细胞移植术治疗翼状胬肉
张建明	河南省太康县人民医院眼科	眼外伤职业眼病杂志	自体角膜缘干细胞移植治疗翼状胬肉
张建玲	宁夏吴忠市人民医院眼科	临床眼科杂志	曲安缩松球结膜下注射治疗春季卡他性结膜炎
张建玲	宁夏回族自治区人民医院宁夏眼科医院	国际眼科杂志	宁夏地区翼状胬肉患病率的流行病学调查
张弘	中国云南省红河州医院眼科	国际眼科杂志	自体带结膜瓣角膜缘干细胞移植治疗翼状胬肉
张强	中国陕西省咸阳市	国际眼科杂志	自体角膜缘上皮移植治疗翼状胬肉52例
张忆	上海市公利医院眼科	临床眼科杂志	表面麻醉在眼科手术中的应用
张志	沈阳市爱尔眼视光医院	中国实用眼科杂志	自体角膜缘干细胞移植联合丝裂霉素C治疗翼状胬肉疗效观察
张志刚	固始县中医院	眼外伤职业眼病杂志	三联术治疗翼状胬肉效果观察
张志峰	山东省荣成市人民医院眼科	临床眼科杂志	荣成市渔民翼状胬肉的流行病学调查
张志清	深圳市梅沙医院	中国实用眼科杂志	IL-1 α在初发与复发性翼状胬肉中的异常表达
张志清	盐田区人民医院眼科	眼外伤职业眼病杂志	初发胬肉与复发胬肉中ⅠL-1α和VEGFR-1的表达相关性研究
张志红	北京市房山区第一医院眼科	国际眼科杂志	自体角膜缘干细胞移植联合rh-EGF治疗翼状胬肉疗效观察
张志红	中山大学中山眼科中心	中华眼科杂志	干眼患者115例的临床特点分析
张怡	第三军医大学大坪医院野战外科研究所眼科中心	中华实验眼科杂志	准分子激光在翼状胬肉治疗中的应用
张悦	四川省人民医院眼科	国际眼科杂志	翼状胬肉术后严重并发症3例
张惠成	杭州市第一人民医院眼科	中国中医眼科杂志	自体带角膜缘干细胞的结膜瓣移位术治疗翼状胬肉
张惠成	杭州市第一人民医院	中华实验眼科杂志	荧光定量聚合酶链反应检测沙眼衣原体
张招德	宁德市医院	眼外伤职业眼病杂志	羊膜移植在翼状胬肉术中的应用
张振义	中国陕西省西安市红庙坡医院中视眼病中心	国际眼科杂志	干细胞移植联合抗代谢药物治疗翼状胬肉
张振坡	郏县人民医院	眼外伤职业眼病杂志	逆行切除联合球结膜移植治疗翼状胬肉
张振永	上海中医药大学附属普陀医院眼科	中华眼科杂志	睑板腺功能异常
张振永	上海中医药大学附属普陀医院	中华眼科杂志	结膜松弛症球结膜组织中热休克蛋白的表达
张改玲	河南医科大学第一附属医院眼科	眼外伤职业眼病杂志	开睑钩翻转眼睑用于沙眼手术的体会
张敏	武汉艾格眼科医院眼表与眼整形科	国际眼科杂志	治疗性软性角膜接触镜在翼状胬肉手术中的应用和评价
张敬先	暨南大学附属深圳市眼科医院	国际眼科杂志	泪点炎的临床观察研究
张文华	北京市眼科研究所	中华眼科杂志	沙眼衣原体--发现与贡献
张文忻	中山大学中山眼科中心中山大学眼科学国家重点实验室	中华眼科杂志	翼状胬肉组织中血管拟态的初步研究
张文忻	中山大学眼科学国家重点实验室	中华实验眼科杂志	CD34在翼状胬肉中表达的意义
张文芳	兰州大学第二临床医学院	国际眼科杂志	甘肃省农村小学生沙眼快速评估的初步调查报告
张文芳	兰州大学第二医院眼科	中国实用眼科杂志	兰州地区细菌性结膜炎的致病菌分布和耐药性分析
张文芳	兰州大学第二医院眼科	国际眼科杂志	甘肃舟曲县藏汉族小学生干眼症的流行病学调查
张文菊	北京医院眼科	中华眼视光学与视觉科学杂志	我国开展角膜塑型术的现状及问题
张斌	巢湖市脱氏眼科医院	眼外伤职业眼病杂志	角膜缘干细胞移植与丝裂霉素C治疗翼状胬肉
张明伟	山东省寿光市人民医院	眼外伤职业眼病杂志	角膜缘上皮双向转移联合丝裂霉素C治疗翼状胬肉
张明昌	华中科技大学同济医学院附属协和医院眼科	临床眼科杂志	姜黄素抑制人血管内皮细胞增殖的研究
张明昌	华中科技大学同济医学院附属协和医院眼科	临床眼科杂志	春季角结膜炎角膜缘病变的手术治疗
张明昌	华中科技大学同济医学院附属协和医院眼科	中国眼耳鼻喉科杂志	美洛昔康对翼状胬肉成纤维细胞增殖抑制的实验研究
张明昌	华中科技大学同济医学院附属协和医院眼科	中华眼科杂志	春季角结膜炎巨大乳头手术治疗的临床分析
张明昌	华中科技大学同济医学院附属协和医院眼科	中华眼科杂志	第15例——双眼疼痛并畏光流泪数日
张明昌	华中科技大学同济医学院附属协和医院眼科	中华实验眼科杂志	维生素E琥珀酸酯抑制人翼状胬肉成纤维细胞生长作用的研究
张明昌	华中科技大学同济医学院附属协和医院眼科	临床眼科杂志	春季角结膜炎乳头病变研究及其治疗的进展
张明昌	华中科技大学同济医学院附属协和医院眼科	国际眼科杂志	NF -κB抑制剂吡咯烷二硫氨基甲酸对人翼状胬肉成纤维细胞增殖的影响
张明昌	华中科技大学同济医学院附属协和医院眼科	中华眼科杂志	翼状胬肉中环氧合酶2的表达及其相关研究
张明昌	华中科技大学同济医学院附属协和医院眼科	中华眼科杂志	重视翼状胬肉的基础与临床研究
张明昌	华中科技大学同济医学院附属协和医院眼科	中华眼视光学与视觉科学杂志	抑肽酶对翼状胬肉成纤维细胞肿瘤坏死因子-α的抑制作用
张明昌	华中科技大学同济医学院附属协和医院眼科	中华实验眼科杂志	过氧化物酶体增生物激活受体激动剂对翼状胬肉成纤维细胞增生的抑制作用
张明昌	华中科技大学同济医学院附属协和医院眼科	临床眼科杂志	姜黄素抑制翼状胬肉成纤维细胞增生的研究
张明昌	华中科技大学同济医学院附属协和医院眼科	中华实验眼科杂志	来氟米特活性代谢物A77 1726对翼状胬肉成纤维细胞增生的影响
张明昌	华中科技大学同济医学院附属协和医院眼科	中华实验眼科杂志	β-NGF对人翼状胬肉成纤维细胞增生的影响
张明昌	华中科技大学附属协和医院眼科	国际眼科杂志	羊膜移植治疗春季角结膜炎的角膜缘病变
张明昌	华中科技大学同济医学院附属协和医院眼科	中华眼视光学与视觉科学杂志	丁酸钠对翼状胬肉成纤维细胞增殖的抑制作用
张明昌	华中科技大学同济医学院附属协和医院眼科	国际眼科杂志	自体角膜缘干细胞移植联合羊膜移植术治疗复发性翼状胬肉的临床研究
张明昌	华中科技大学同济医学院附属协和医院眼科	国际眼科杂志	紫杉醇对体外人翼状胬肉成纤维细胞的抑制作用
张明昌	华中科技大学同济医学院附属协和医院眼科	国际眼科杂志	粉防己碱对翼状胬肉成纤维细胞增生作用的研究
张映萍	中国湖南省湘潭市中心医院眼科	国际眼科杂志	纤维蛋白胶联合绷带型角膜接触镜在翼状胬肉切除术中的应用
张映霞	广东省梅县人民医院五官科	中华眼科杂志	广东省梅县盲和低视力流行病学调查
张春梅	南阳市眼科医院	眼外伤职业眼病杂志	自体角膜缘上皮移植治疗翼状胬肉疗效观察
张春燕	广东省汕尾市逸挥基金医院眼科	临床眼科杂志	翼状胬肉角膜表面屈光状态分析
张春燕	广东省汕尾逸挥基金医院眼科	中国实用眼科杂志	翼状胬肉不同手术方法疗效分析
张晓	核工业四一六医院眼科	国际眼科杂志	翼状胬肉术后90Srβ射线敷贴治疗疗效观察及复发相关因素分析
张晓丽	中国陕西省西安市第四人民医院眼科	国际眼科杂志	西安周边50岁及以上农村人口眼病调查
张晓农	华中科技大学同济医学院附属同济医院眼科	临床眼科杂志	重组人干扰素α1b滴眼液对体外培养翼状胬肉成纤维细胞增殖的影响
张晓农	华中科技大学同济医学院附属同济医院眼科	中华实验眼科杂志	翼状胬肉发病机制及治疗研究进展
张晓利	郑州市眼科医院	中国中医眼科杂志	保存羊膜及丝裂霉素对翼状胬肉眼表的影响
张晓博	温州医学院附属眼视光医院	中华实验眼科杂志	Sj(o)gren综合征患者的角膜激光共焦显微镜活体观察
张晓承	黔南州人民医院	眼外伤职业眼病杂志	下方带蒂角膜缘上皮移植治疗翼状胬肉
张晓湄	广西柳州市人民医院眼科	临床眼科杂志	复合式翼状胬肉切除术的临床应用
张晓琳	中国广州市海珠区第一人民医院眼科	国际眼科杂志	新鲜羊膜移植治疗眼表疾病的临床观察
张晓萍	常德爱尔眼科医院	中国实用眼科杂志	翼状胬肉术后角膜鳞状上皮癌一例
张晶	中国人民解放军第五三五医院	眼科	自体角膜缘干细胞移植与羊膜移植治疗翼状胬肉的对比研究
张暹梅	浙江衢州市中医院眼科	眼外伤职业眼病杂志	丝裂霉素C联合角膜缘干细胞移植术治疗翼状胬肉
张曼萍	海口市人民医院	眼外伤职业眼病杂志	自体角膜缘干细胞移植治疗翼状胬肉临床观察
张月媛	巢湖市脱氏眼科医院	眼外伤职业眼病杂志	角膜缘干细胞移植与丝裂霉素C治疗翼状胬肉
张月梅	兰州医学院第一附属医院	眼外伤职业眼病杂志	角膜缘干细胞移植或羊膜移植治疗翼状胬肉
张月梅	兰州大学第一医院眼科	中国中医眼科杂志	自体角膜缘干细胞及羊膜对翼状胬肉TNF-α、IL-6表达的影响
张月玲	河北省保定市第一中心医院眼科	临床眼科杂志	羊膜移植在复发性翼状胬肉手术中的应用
张月琴	河南省眼科研究所	中国实用眼科杂志	富马酸酮替芬滴眼液治疗季节变应性结膜炎眼痒及结膜充血的疗效观察
张月琴	河南省眼科研究所	中华眼科杂志	加替沙星和左氧氟沙星治疗细菌性结膜炎的疗效对比研究
张月琴	河南省眼科研究所	中国实用眼科杂志	小牛血去蛋白提取物眼凝胶治疗角膜上皮缺损的多中心临床研究
张月琴	河南省眼科研究所	中华实验眼科杂志	盐酸左氧氟沙星滴眼液治疗细菌性结膜炎及角膜炎随机双盲对照临床研究
张有亭	河南许昌市中心医院眼科	中国实用眼科杂志	角膜缘干细胞移植联合丝裂霉素C防止翼状胬肉术后复发
张朝然	复旦大学附属眼耳鼻喉科医院眼科	中国眼耳鼻喉科杂志	关于翼状胬肉诊疗的一些想法
张朝然	复旦大学附属眼耳鼻喉科医院	眼外伤职业眼病杂志	结膜乳头切除加丝裂霉素C治疗春季角结膜炎
张杰超	暨南大学医学院三附院	眼外伤职业眼病杂志	自体角膜缘上皮移植术治疗翼状胬肉的临床报告
张林	西安交通大学第一附属医院眼科	国际眼科杂志	翼状胬肉术前泪膜稳定性与术后复发相关性临床观察
张林军	新疆生产建设兵团总医院	眼外伤职业眼病杂志	巩膜表层血管烧灼联合推进式结膜移植治疗翼状胬肉
张桂丽	上海中医药大学附属普陀医院眼科	国际眼科杂志	利用OCT观察流行性出血性结膜炎的临床研究
张梅	中山大学中山眼科中心	中华眼科杂志	干眼患者115例的临床特点分析
张梅	中山大学中山眼科中心	中国实用眼科杂志	翼状胬肉切除对泪液功能的影响
张梅	中山大学眼表疾病研究中心	中国实用眼科杂志	过敏性结膜炎的临床特点
张梅	中山大学中山眼科中心	中华眼科杂志	翼状胬肉上皮细胞p53蛋白的表达及其功能状态的研究
张楠	天津市眼科医院天津医科大学眼科临床学院眼眶病眼整形科	中国实用眼科杂志	重视眼科影像学检查提高临床诊断率
张歆	中国河北省沧州市	国际眼科杂志	河北省沧州城区6~14岁学龄儿童眼病现况调查
张永鹏	北京同仁医院眼科	眼外伤职业眼病杂志	结膜瓣移植联合干扰素治疗复发性泡性角膜结膜炎
张汀	江苏省徐州市铁路医院眼科	眼外伤职业眼病杂志	自体角膜缘干细胞移植治疗复发性翼状胬肉
张汉武	湖北省宜昌市夷陵医院眼科	中国眼耳鼻喉科杂志	氟康唑联合聚维酮碘治疗真菌性结膜炎
张洁	华中科技大学同济医学院附属协和医院眼科	中华实验眼科杂志	来氟米特活性代谢物A77 1726对翼状胬肉成纤维细胞增生的影响
张津	深圳市南山区人民医院眼科	眼外伤职业眼病杂志	氟美瞳、色苷酸钠在翼状胬肉术后的观察
张津	深圳市南山人民医院眼科	中国眼耳鼻喉科杂志	局部高浓度青霉素治疗新生儿淋菌性结膜炎
张津	深圳市南山人民医院眼科	临床眼科杂志	局部高浓度青霉素对新生儿淋菌性结膜炎治疗观察
张洪勋	新疆乌苏第15医院眼科	眼科	FGI-A型沙眼治疗仪治疗进行期沙眼43例
张济明	苏州大学附属第一医院眼科	眼外伤职业眼病杂志	自体角膜缘移植羊膜移植治疗翼状胬肉
张海勤	东营市人民医院	眼外伤职业眼病杂志	纤维蛋白胶在翼状胬肉切除联合自体角膜缘干细胞移植术中的应用研究
张海娟	首都医科大学附属同仁医院眼科中心	中国中医眼科杂志	珍芪滴眼液治疗慢性结膜炎的实验研究
张海江	河北省保定市第一中心医院眼科	临床眼科杂志	羊膜移植在复发性翼状胬肉手术中的应用
张海江	三峡大学第一临床医学院湖北省宜昌市中心人民医院眼科	国际眼科杂志	改良式角膜缘干细胞移植治疗原发性翼状胬肉的手术体会
张海波	白山市中心医院眼科	眼外伤职业眼病杂志	环形羊膜缝合联合丝裂霉素治疗翼状胬肉
张海燕	中国辽宁省辽阳市第三人民医院眼科	国际眼科杂志	自体角膜缘干细胞移植术治疗原发性翼状胬肉94例
张淑妮	中国广东省梅州市嘉应学院医学院附属医院眼科	国际眼科杂志	角膜缘干细胞联合羊膜移植治疗翼状胬肉疗效观察
张淑娥	山东淄博市第一医院眼科	眼科	翼状胬肉切除术后平阳霉素的使用
张清炯	中山大学中山眼科中心遗传分子生物学实验室	临床眼科杂志	PCR扩增技术在新生儿结膜炎中的诊断应用
张清生	河南省濮阳市眼科研究所	眼外伤职业眼病杂志	角膜缘干细胞联合结膜上皮移植治疗复发性翼状胬肉的研究
张潇	中国医学科学院北京协和医院眼科	眼科	过敏性结膜炎的流行病学及奥洛他定滴眼液开放性多中心治疗的初步效果
张燕	首都医科大学附属北京儿童医院眼科	中国斜视与小儿眼科杂志	Ritleng 泪道插管术治疗结膜炎导致的儿童继发性泪道阻塞疗效观察
张爱华	上海市宝山中心医院	眼外伤职业眼病杂志	翼状胬肉术中两种不同缝线对复发的影响
张爱慧	山东省东阿县人民医院眼科	中华实验眼科杂志	结膜吸吮线虫病二例
张爽	黑龙江省齐齐哈尔市五官医院眼科	眼科	基层医院翼状胬肉切除术角膜穿孔并发症二例
张玉娟	钦州市第二人民医院	眼外伤职业眼病杂志	羊膜移植治疗难治性眼表疾病的临床效果
张玉梅	山东省新泰市人民医院	眼外伤职业眼病杂志	显微镜下球结膜移植法治疗翼状胬肉84例体会
张玉瑶	安徽省东至县人民医院眼科	中国中医眼科杂志	翼状胬肉两种不同术式疗效比较
张玮	中国上海市杨浦区市东医院眼科	国际眼科杂志	翼状胬肉大小与角膜散光的关系
张琛	天津医科大学眼科研究所	国际眼科杂志	表面麻醉下翼状胬肉手术中应用纤维蛋白胶的效果
张琛	天津医科大学眼科医院	国际眼科杂志	纤维蛋白胶在翼状胬肉切除联合自体角膜缘干细胞移植术中的临床效果
张琦	浙江省台州医院路桥院区眼科	中国实用眼科杂志	角膜缘干细胞移植术和羊膜移植术治疗复发性翼状胬肉的比较
张琦	广东省中山市人民医院眼科	中华实验眼科杂志	脱水钝性剥离联合丝裂霉素C治疗翼状胬肉疗效观察
张瑛	新疆生产建设兵团总医院	眼外伤职业眼病杂志	巩膜表层血管烧灼联合推进式结膜移植治疗翼状胬肉
张瑾	湖南桃江县人民医院眼科	眼外伤职业眼病杂志	翼状胬肉手术中带状角膜缘组织移植及丝裂霉素C应用的意义
张百红	兰州军区兰州总医院肿瘤科	中国斜视与小儿眼科杂志	重度春季角结膜炎一例
张皙	上海交通大学附属市第一人民医院眼科	中国眼耳鼻喉科杂志	羊膜移植在结膜重建中的应用
张皙	上海市第一人民医院眼科	临床眼科杂志	羊膜移植联合眼表润滑剂及配镜治疗初发性翼性胬肉
张皙	上海市第一人民医院眼科	眼外伤职业眼病杂志	翼状胬肉切除联合丝裂霉素C应用致角膜自融穿孔一例
张碧华	攀枝花学院附属医院眼科	国际眼科杂志	翼状胬肉术后巩膜融解14例临床分析
张磊	上海市杨浦区中心医院眼科	眼外伤职业眼病杂志	翼状胬肉手术标本中MMP-2及MMP-9的表达和意义
张磊	上海市杨浦中心医院眼科	眼外伤职业眼病杂志	翼状胬肉切除术后角膜散光改善的研究
张磊	中国人民解放军第161中心医院眼科	国际眼科杂志	角膜缘干细胞移植术治疗复发性翼状胬肉的疗效
张磊	上海市杨浦区中心医院	眼外伤职业眼病杂志	翼状胬肉切除术后角膜地形图改变
张祺	中国湖北省武汉市第一医院眼科	国际眼科杂志	翼状胬肉的个体化手术治疗
张秀伶	北京市平谷区医院眼科	眼科	多功能电离子治疗机治疗泪小点狭窄的临床观察
张秀英	山东省单县中心医院眼科	中华眼视光学与视觉科学杂志	成年人淋菌性角膜溃疡一例
张秀萍	济南市第四人民医院眼科	中国中医眼科杂志	角膜缘干细胞移植治疗复发性翼状胬肉的临床观察
张立友	河北省沧州眼科医院	临床眼科杂志	老年性下睑外翻手术治疗的探讨
张立新	湖北省老河口市第一医院眼科	眼外伤职业眼病杂志	羊膜移植治疗翼状胬肉的临床观察
张繁友	大连市第三人民医院眼科	中国实用眼科杂志	平阳霉素结膜下注射治疗复发性翼状胬肉疗效观察
张红	陕西省商洛市中心医院眼科	临床眼科杂志	眼部带状疱疹43例临床分析
张红	昆明医学院第四附属医院眼科	中华实验眼科杂志	睑缘切开带蒂轮匝肌瓣充填术治疗严重上睑内翻倒睫疗效观察
张红兵	中国陕西省西安市第一医院	国际眼科杂志	瘢痕性天疱疮35例临床分析
张纯	北京大学第三医院	眼外伤职业眼病杂志	胚胎角膜干细胞移植治疗翼状胬肉的远期临床观察
张纯涛	陕西省人民医院眼科	中国实用眼科杂志	下泪小点息肉致长期泪溢二例
张绪富	湖北航天医院眼科	国际眼科杂志	原发性翼状胬肉两种治疗方法的疗效观察
张缨	华中科技大学同济医学院附属协和医院	中华眼视光学与视觉科学杂志	基质细胞衍生因子及其受体CXCR4在翼状胬肉的异常表达
张缨	同济医科大学附属协和医院眼科	中华实验眼科杂志	春季结膜炎患者血清中的IL-1β及IL-8
张美洪	厦门市第一医院眼科中心杏林院区	中国实用眼科杂志	羊膜治疗部分眼表疾病的疗效观察
张翠荣	新疆昌吉州人民医院	眼外伤职业眼病杂志	羊膜移植与平阳霉素治疗翼状胬肉的临床观察
张翠荣	新疆昌吉州人民医院眼科	临床眼科杂志	丝裂霉素C眼科应用引起巩膜溶解临床报告
张翠薇	深圳市保健委员会办公室	中国中医眼科杂志	化胬抑复冲剂降低翼状胬肉术后复发率的临床研究
张胜男	中国医科大学附属盛京医院眼科	国际眼科杂志	蒲地蓝消炎口服液治疗流行性角结膜炎的临床疗效
张良	广东省人民医院眼科	中国实用眼科杂志	冬季广州市眼科门诊病人眼病构成情况调查
张艳丽	中山大学中山眼科中心中山大学眼科学国家重点实验室	国际眼科杂志	汉防己甲素抑制翼状胬肉成纤维细胞增殖的研究
张艳青	复旦大学附属眼耳鼻喉科医院	中华眼视光学与视觉科学杂志	还原型谷胱甘肽滴眼液促进翼状胬肉术后角膜上皮修复
张芳丽	武警总医院与辽宁医学院	中华眼科杂志	先天性无泪症伴鳄鱼泪一例
张英朗	河南省眼科医院	眼外伤职业眼病杂志	丝裂霉素C应用于翼状胬肉切除术的研究
张英爽	南阳市眼科医院	眼外伤职业眼病杂志	自体角膜缘上皮移植治疗翼状胬肉疗效观察
张莉	四川大学华西医院眼科	国际眼科杂志	成都市767例干部体检眼科疾病构成分析
张莉	深圳市儿童医院眼科	临床眼科杂志	FK506在实验性过敏性结膜炎局部免疫调控的作用
张莉	首都医科大学附属北京同仁医院	眼科	北京市城乡限定人群白内障手术负荷量及术后视力评价
张莉	深圳市儿童医院眼科	国际眼科杂志	FK506对实验性过敏性结膜炎细胞因子表达的影响
张莉	中国人民解放军第273医院眼科	中国中医眼科杂志	库尔勒市中老年人翼状胬肉的流行病学特点
张莉	河南省直属机关第一医院眼科	眼外伤职业眼病杂志	平阳霉素治疗翼状胬肉十年疗效观察
张莉薇	中南大学湘雅二医院眼科	国际眼科杂志	翼状胬肉发病机制的分子生物学研究进展
张蓉	乌鲁木齐市武警新疆总队医院眼科	国际眼科杂志	睑板腺功能异常的临床观察
张蕾	中国广东省肇庆市第一人民医院眼科	国际眼科杂志	改良羊膜及角膜缘干细胞移植联合MMC治疗复发性翼状胬肉
张虹	云南省红十字会医院眼科	眼外伤职业眼病杂志	空气中的污染物致翼状胬肉的职业流行病学调查报告
张虹	华中科技大学同济医学院附属同济医院眼科	中华眼科杂志	糖皮质激素性高眼压患者外周血单个核细胞糖皮质激素受体α和β的表达
张诚玥	首都医科大学附属北京儿童医院眼科	中国斜视与小儿眼科杂志	Ritleng 泪道插管术治疗结膜炎导致的儿童继发性泪道阻塞疗效观察
张贤文	解放军第五医院	眼外伤职业眼病杂志	羊膜移植治疗眼表疾病临床观察
张贻转	武汉科技大学附属天佑医院眼科	国际眼科杂志	翼状胬肉切除联合自体角膜缘干细胞移植与联合羊膜移植的疗效比较
张贻转	武汉科技大学附属天佑医院	眼外伤职业眼病杂志	风湿病患者双眼翼状胬肉术后发生坏死性巩膜炎
张越骊	深圳市儿童医院眼科	临床眼科杂志	累及眼部的Stevens-Johnson综合征1例
张采华	福建省永安市三明第二医院眼科	中国实用眼科杂志	羊膜移植治疗翼状胬肉50例临床探讨
张金峰	商河县中医医院眼科	中国中医眼科杂志	左眼角巩膜长期存留异物1例
张金顺	中山大学中山眼科中心	中国实用眼科杂志	医源性散瞳诱发青光眼急性发作的临床分析
张鑫	四川大学华西医院眼科	国际眼科杂志	他克莫司治疗春季卡他性角结膜炎的疗效分析
张键	湖南省常德市第一人民医院眼科	眼外伤职业眼病杂志	羊膜及角膜缘上皮移植术治疗复发性翼状胬肉
张隆	上海中医药大学附属普陀医院	中华眼科杂志	结膜松弛症球结膜组织中热休克蛋白的表达
张隆	上海中医药大学附属普陀医院实验中心	国际眼科杂志	结膜松弛症球结膜成纤维细胞培养的研究
张雅丽	秦皇岛市第一医院	眼外伤职业眼病杂志	自体结膜角膜缘上皮移植治疗翼状胬肉临床观察
张雪倩	北京中医药大学第三附属医院眼科	国际眼科杂志	自体角膜缘干细胞移植联合丝裂霉素治疗翼状胬肉的临床效果
张霞	郑州纺织机械厂职工医院眼科	眼外伤职业眼病杂志	自体角膜缘干细胞移植联合丝裂霉素C治疗翼状胬肉
张青	安徽医科大学第二附属医院眼科	临床眼科杂志	10-0缝线和8-0可吸收缝线对翼状胬肉切除术后眼部舒适度的影响
张青	青海省中医院眼科	临床眼科杂志	显微自体干细胞移植治疗50例翼状胬肉临床疗效观察
张青	中国青海省四宁市	国际眼科杂志	自体干细胞移植治疗翼状胬肉50例疗效观察
张青霞	青海省中医院眼科	临床眼科杂志	显微自体干细胞移植治疗50例翼状胬肉临床疗效观察
张静	南阳市眼科医院	眼外伤职业眼病杂志	翼状胬肉结膜移植联合塞替哌双氯酚酸钠观察
张静辉	暨南大学附属第一医院眼科	中华实验眼科杂志	丝裂霉素C对翼状胬肉成纤维细胞膜通透性及超微结构的影响
张高玲	珠海市香洲区人民医院眼科	眼外伤职业眼病杂志	新鲜羊膜联合自体角膜缘移植治疗复发性翼状胬肉
张鹏举	黄石爱康医院眼科	中华眼视光学与视觉科学杂志	儿童过敏性结膜炎与变应性疾病的相关性
张龄洁	台州市椒江眼科医院	眼外伤职业眼病杂志	翼状胬肉逆向切除联合羊膜移植的临床观察
張健	，中國山東省諸城市中醫院眼科	国际眼科杂志	結膜下注射平陽霉素致眼球内陷2例報道
張新青	中國河北省清河縣第二人民醫院眼科	国际眼科杂志	中西醫結合治瘵特异性幹眼癥
張洪沛	中國遼宁大連市第二人民醫院眼科	国际眼科杂志	自體角膜缘上皮移植聯合5一氟脲嘧啶治瘵翼狀胬肉的臨床觀察
彭云	华中科技大学同济医学院附属协和医院眼科	中华眼科杂志	翼状胬肉中环氧合酶2的表达及其相关研究
彭云	华中科技大学同济医学院附属协和医院眼科	中国眼耳鼻喉科杂志	美洛昔康对翼状胬肉成纤维细胞增殖抑制的实验研究
彭伟	深圳市布吉人民医院眼科	眼外伤职业眼病杂志	改良翼状胬肉手术研究报告
彭伟	深圳市人民医院暨南大学医学院二附院	眼科	新鲜羊膜移植治疗眼化学伤和翼状胬肉
彭勇开	广东省佛山市南海区大沥医院眼科	中国实用眼科杂志	复发性翼状胬肉角膜缘干细胞移植远期疗效观察
彭华	云南省中医医院	中国中医眼科杂志	自体角膜缘干细胞移植术联合中药治疗翼状胬肉疗效观察
彭坤	新乡医学院第一附属医院眼科	国际眼科杂志	长期联合应用噻吗洛尔对结膜组织炎性反应的影响
彭娟	广州医学院第二附属医院眼科	中国实用眼科杂志	翼状胬肉根治手术预防复发的效果观察
彭子春	广西南宁市第一人民医院	眼外伤职业眼病杂志	保存人羊膜在眼表疾病中的应用
彭家民	贵州航天医院	眼外伤职业眼病杂志	初发翼状胬肉单纯切除联合丝裂霉素C的治疗观察
彭寿雄	中山大学中山眼科中心	中国实用眼科杂志	医源性散瞳诱发青光眼急性发作的临床分析
彭招华	解放军第一七一医院	眼外伤职业眼病杂志	丝裂霉素C在翼状胬肉手术中的应用
彭昌福	解放军第一六三医院眼科	中国实用眼科杂志	FⅧ-RAg VEGF在翼状胬肉中表达和微血管密度检测及其意义
彭昌福	解放军第一六三医院眼科	中华眼科杂志	翼状胬肉中诱导一氧化氮合酶与FⅧ相关抗原表达的研究
彭涛	武警浙江总队医院	中国中医眼科杂志	显微镜下自体角膜缘干细胞移植治疗翼状胬肉
彭清华	湖南中医药大学第一附属医院眼科	中国中医眼科杂志	眼科围手术期的中医药治疗
彭秀军	海军总医院眼科	国际眼科杂志	急性结膜炎伴发脓液潴留性囊肿1例
彭秀军	海军总医院眼科	中华眼科杂志	以伪膜性结膜炎为首发表现的水痘一例
彭秀军	海军总医院眼科	中国实用眼科杂志	自体骨髓间充质干细胞移植改善重度眼表损伤临床观察
彭秀军	海军总医院眼科	中国中医眼科杂志	上泪小管炎误诊为角结膜炎1例
彭素霞	中国湖南省浏阳市眼科医院眼科	国际眼科杂志	自体结膜移植术联合丝裂霉素C治疗复发性翼状胬肉
彭红珍	中国湖北省武汉市第十一医院眼科	国际眼科杂志	新鲜羊膜联合自体角膜缘移植治疗复发性翼状胬肉的疗效分析
彭莹	北京市海淀医院眼科	临床眼科杂志	翼状胬肉逆行切除联合带蒂结膜瓣移植术的疗效观察
律鹏	四川I大学华西医院眼科中心	国际眼科杂志	翼状胬肉的流行病学研究现状
徐世勤	武汉市第七医院眼科	中国实用眼科杂志	新鲜羊膜移植治疗翼状胬肉48例临床观察
徐丽	中国辽宁省沈阳市第四人民医院眼科	国际眼科杂志	糖皮质激素眼液在流行性角结膜炎治疗中的应用
徐亮	首都医科大学附属北京同仁医院跟科中心北京市眼科研究所	眼科	北京农村老年居民翼状胬肉患病情况分析
徐亮	首都医科大学附属北京同仁医院	眼科	北京市城乡限定人群白内障手术负荷量及术后视力评价
徐亮	首都医科大学北京同仁眼科中心	中华眼科杂志	北京特定地区翼状胬肉患病率的流行病学调查
徐兆宏	中国陕西省渭南市第二医院眼科中心	国际眼科杂志	手术显微镜下翼状胬肉切除联合丝裂霉素C应用98例疗效观察
徐冬冬	中国协和医科大学	中国实用眼科杂志	倒睫激光疗效106例观察
徐凤	天津大港油田总医院眼科	国际眼科杂志	双氯芬酸钠结合中药熏眼辅助治疗泡性结膜炎的临床观察
徐凤芹	宁河县医院眼科	眼外伤职业眼病杂志	翼状胬肉切除自体角膜上皮和结膜移植观察
徐凯	中国江苏省姜堰市人民医院眼科	国际眼科杂志	自体角膜缘干细胞移植联合MMC治疗翼状胬肉疗效观察
徐凯	新疆焉耆县妇幼保健站	中国中医眼科杂志	库尔勒市中老年人翼状胬肉的流行病学特点
徐善卿	陕西省人民医院眼科	眼外伤职业眼病杂志	翼状胬肉与角膜曲率
徐国兴	福建医科大学附属第一医院	国际眼科杂志	儿童春季卡他性角结膜炎与干眼症相关性分析
徐国兴	福建医科大学附属第一医院眼科	国际眼科杂志	干眼症83例病因诊断与误诊分析
徐国兴	福建医科大学附属一院眼科	中国实用眼科杂志	系统性红斑狼疮患者眼表损害及相关抗体检测
徐国兴	福建省眼科研究所	眼科	自体角膜缘干细胞移植治疗翼状胬肉
徐国兴	福建医科大学第一附属医院	中华眼视光学与视觉科学杂志	基质金属蛋白酶-1及其抑制剂和转化生长因子-β1在翼状胬肉中的表达及意义
徐国兴	福建医科大学附属第一医院眼科	国际眼科杂志	温州市农村防盲治盲情况调查与分析
徐国兴	福建医科大学附属第一医院福建省眼科研究所	中国实用眼科杂志	翼状胬肉中细胞增殖与凋亡相关基因蛋白的表达及其意义
徐大梅	新乡市中医院	中国中医眼科杂志	万应蝉花散治疗春季结膜炎100例临床观察
徐威	汕头大学医学院第一附属医院眼科	国际眼科杂志	角膜缘干细胞移植治疗翼状胬肉合并结膜松弛症的观察
徐威	汕头大学医学院第一附属医院眼科	中国眼耳鼻喉科杂志	曲安奈德上穹窿结膜下注射治疗重症春季角结膜炎
徐岩	河南省科研究所	中华实验眼科杂志	复方酮替芬滴眼剂对实验过敏性结膜炎的疗效观察
徐岩	河南省眼科研究所	中华实验眼科杂志	变应性结膜炎动物模型
徐岬	淮安市第二人民医院	眼外伤职业眼病杂志	羊膜移植治疗翼状胬肉临床分析
徐峰	湖北省仙桃市中医院眼科	临床眼科杂志	翼状胬肉切除结膜瓣转位包埋术疗效观察
徐常山	中国江苏省姜堰市人民医院眼科	国际眼科杂志	自体角膜缘干细胞移植联合MMC治疗翼状胬肉疗效观察
徐建峰	南京军区第180医院眼科	中国斜视与小儿眼科杂志	皮质激素性青光眼12例
徐建江	复旦大学附属眼耳鼻喉科医院眼科	中华眼科杂志	激光共聚焦显微镜观察春季角结膜炎患者的角膜形态变化
徐建江	复旦大学附属眼耳鼻喉科医院	中华眼视光学与视觉科学杂志	0.1%普拉洛芬滴眼液治疗急性变态反应性结膜炎的疗效
徐建江	复旦大学附属眼耳鼻喉科医院	眼外伤职业眼病杂志	结膜乳头切除加丝裂霉素C治疗春季角结膜炎
徐建江	复旦大学附属眼耳鼻喉科医院	中国实用眼科杂志	双氯芬酸钠透明质酸钠滴眼液治疗急性变态反应性结膜炎评价
徐建锋	中国人民解放军第一八○医院眼科	国际眼科杂志	翼状胬肉切除联合角膜缘干细胞移植术前术后的泪膜变化
徐强	连云港市第二人民医院眼科	眼外伤职业眼病杂志	海水盐场职工翼状胬肉患病率分析及手术治疗的临床观察
徐悦	辽宁省朝阳市中心医院眼科	中国实用眼科杂志	新鲜羊膜移植治疗复发性翼状胬肉临床观察
徐慧艳	无锡市第二人民医院眼科	中华实验眼科杂志	人乳头状瘤病毒在翼状胬肉发病机制中的作用
徐教伦	山东省东营市人民医院	中国中医眼科杂志	翼状胬肉钝性剥离联合纤维蛋白胶固定自体角膜缘干细胞移植术的临床应用
徐教伦	东营市人民医院	眼外伤职业眼病杂志	纤维蛋白胶在翼状胬肉切除联合自体角膜缘干细胞移植术中的应用研究
徐文双	黑龙江省齐齐哈尔市五官医院眼科	眼科	基层医院翼状胬肉切除术角膜穿孔并发症二例
徐文生	平果县人民医院眼科	眼科	感染性眼病的细菌病原学及药物敏感性分析
徐文生	中国广西壮族自治区平果县人民医院眼科	国际眼科杂志	大规模白内障复明手术中同时行胬肉切除联合球结膜瓣转移手术的应用
徐新生	广东省佛山市南海区大沥医院眼科	中国实用眼科杂志	复发性翼状胬肉角膜缘干细胞移植远期疗效观察
徐方	上海市奉贤县中医院眼科	眼科	翼状胬肉术后真菌感染一例报告
徐方	奉贤区中医医院	眼外伤职业眼病杂志	翼状胬肉侵入角膜程度对屈光状态的影响
徐方	上海市奉贤县中医院眼科	眼外伤职业眼病杂志	翼状胬肉切除结膜瓣绕转巩膜裸露术的疗效观察
徐昌立	广西凭祥市人民医院眼科	眼外伤职业眼病杂志	翼状胬肉转移联合手术及术后康宁克通A应用
徐明	浙江省温州医学院附属眼视光医院	中华实验眼科杂志	翼状胬肉患者术前和术后泪液功能的临床研究
徐昕	宁波市第二医院眼病中心	中国中医眼科杂志	翼状胬肉切除联合改良滑行结膜瓣移植术的疗效观察
徐春光	解放军59中心医院眼科	临床眼科杂志	四头带加压致角膜后弹力层断裂2例
徐晓燕	新疆维吾尔自治区人民医院眼科	眼科	先天性眼皮肤黑变病继发青光眼一例
徐智勇	重庆医科大学附属第二医院眼屈光中心	中国实用眼科杂志	眼局部用药所致干眼的诊断和治疗
徐月清	河北职工医学院病理生理教研室	中华实验眼科杂志	术中应用丝裂霉素C治疗翼状胬肉实验和临床研究
徐林	暨南大学医学院深圳眼科中心深圳市眼科医院	国际眼科杂志	翼状胬肉眼使用电脑验光和视网膜检影测定散光的对比研究
徐格致	复旦大学附属眼耳鼻喉科医院眼科	中华实验眼科杂志	异位性皮炎的眼部并发症
徐永根	浙江省江山市中医院眼科	中国实用眼科杂志	翼状胬肉术中丝裂霉素C的应用
徐永根	浙江省绍兴市人民医院眼科	中国实用眼科杂志	翼状胬肉切除术中与术后应用丝裂霉素C的比较
徐永根	浙江省绍兴市人民医院眼科	眼科	翼状胬肉切除术中丝裂霉素C的应用
徐海龙	华中科技大学同济医学院附属孝感医院眼科	国际眼科杂志	5-FU联合自体角膜缘干细胞移植治疗复发性翼状胬肉
徐涤非	辽宁省抚顺市眼病医院	临床眼科杂志	巩膜暴露区板层角膜移植治疗复发性翼状胬肉
徐深	河北省沧州眼科医院	中华眼科杂志	板层巩膜移植治愈真菌性巩膜炎一例
徐深	中国河北省沧州市	国际眼科杂志	河北省沧州城区6~14岁学龄儿童眼病现况调查
徐燕妮	中國吉林省四平市中心醫院眼科	国际眼科杂志	自體眼表移植術治瘵翼狀胬肉
徐珊琪	汕头大学医学院第一附属医院眼科	临床眼科杂志	翼状胬肉术后滴用0.05g/L丝裂霉素C的疗效观察
徐翀	上海市曙光医院宝山分院	眼外伤职业眼病杂志	翼状胬肉术中改良的止血方法的临床观察
徐翀	上海市宝山区宝山中心医院	眼外伤职业眼病杂志	羊膜移植与自体角膜缘干细胞移植治疗翼状胬肉的效果对比
徐芝灵	商丘市第一人民医院眼科	眼外伤职业眼病杂志	翼状胬肉术中应用丝裂霉素与羊膜移植的效果比较
徐荣平	浙江省宁波光明眼病医院	临床眼科杂志	宁波地区沙眼患病率调查
徐蔚	同济大学附属同济医院眼科	眼外伤职业眼病杂志	前段光学相干断层成像测量翼状胬肉术后结膜植片厚度的临床研究
徐辉勇	鄂州市中心医院眼科	眼外伤职业眼病杂志	翼状胬肉两种不同术式的临床观察
徐金华	江苏省中医院眼科	国际眼科杂志	翼状胬肉切除联合带蒂结膜瓣移植术
徐锦堂	暨南大学医学院一附院眼科	眼外伤职业眼病杂志	自体角膜缘上皮移植术治疗翼状胬肉的临床报告
徐锦堂	暨南大学医学院眼科研究室	中华实验眼科杂志	翼状胬肉组织中胶原纤维的病理学改变
徐锦堂	暨南大学医学院眼科	眼外伤职业眼病杂志	角膜缘移植联合羊膜移植治疗角膜缘缺陷症
徐锦堂	暨南大学医学院附属一医院眼科	眼外伤职业眼病杂志	羊膜联合自体角膜缘移植治疗复发性翼状胬肉
徐颖	牡丹江医学院红旗医院一门诊眼2科	眼外伤职业眼病杂志	铁水烧伤继发假性翼状胬肉的治疗一例
徐黛丽	中国广东省肇庆市第一人民医院眼科	国际眼科杂志	翼状胬肉联合羊膜移植手术失败的临床分析
念其钱	福州市第二医院病理科	中国实用眼科杂志	翼状胬肉的发生与角膜缘干细胞缺乏的病理研究
忽俊	上海市宝山区宝山中心医院	眼外伤职业眼病杂志	羊膜移植与自体角膜缘干细胞移植治疗翼状胬肉的效果对比
忽俊	上海市曙光医院宝山分院	眼外伤职业眼病杂志	翼状胬肉术中改良的止血方法的临床观察
忽俊	复旦大学附属眼耳鼻喉科医院眼科	中国眼耳鼻喉科杂志	眼眶孤立性纤维瘤1例
惠希瑞	南阳市眼科医院	眼外伤职业眼病杂志	自体角膜缘上皮移植治疗翼状胬肉疗效观察
惠晓颖	中国陕西省富平县中医医院眼科	国际眼科杂志	瘢痕性天疱疮35例临床分析
戎光	中國吉林省四平市中心醫院眼科	国际眼科杂志	自體眼表移植術治瘵翼狀胬肉
戎君	上海大华医院眼科	中国实用眼科杂志	532激光治疗早期翼状胬肉的临床观察
成传英	宜昌市第二人民医院	眼外伤职业眼病杂志	结膜瓣移植联合干扰素治疗复发性泡性角膜结膜炎
成功	江苏省通州市第三人民医院	临床眼科杂志	康宁克通-A球结膜下注射治疗春季卡他性结膜炎
成拾明	温州医学院附属眼视光医院	中国实用眼科杂志	应用活体共焦显微镜观察翼状胬肉组织结构
成璞	宁波李惠利医院眼科	眼科	翼状胬肉复发与组织病理学的关系
成璞	浙江宁波李惠利医院眼科	中国实用眼科杂志	塑料薄膜在翼状胬肉手术中的应用
成璞	浙江省宁波市李惠利医院眼科	眼外伤职业眼病杂志	不同浓度平阳霉素预防翼状胬肉复发的效果
成进魁	武汉大学人民医院眼科中心	国际眼科杂志	原发性进展型翼状胬肉与泪膜的相关性研究
戴三友	安徽医科大学附属医院眼科	眼外伤职业眼病杂志	角膜缘上皮联合羊膜移植治疗眼表疾病的研究
戴三友	苏州大学附属第一医院眼科	眼外伤职业眼病杂志	自体角膜缘移植羊膜移植治疗翼状胬肉
戴健荣	高要市人民医院	眼外伤职业眼病杂志	自体角膜缘干细胞移植术治疗翼状胬肉
戴峥	宁波市第二医院眼病中心	中国中医眼科杂志	翼状胬肉切除联合改良滑行结膜瓣移植术的疗效观察
戴涛	郑州市第二人民医院	眼外伤职业眼病杂志	翼状胬肉切除联合自体干细胞移植的临床研究
戴涛	郑州市眼科医院	中国中医眼科杂志	保存羊膜及丝裂霉素对翼状胬肉眼表的影响
戴瑞	宿迁市钟吾医院眼科	眼外伤职业眼病杂志	萘敏维联合微量地塞米松在翼状胬肉围手术期应用
戴红蕾	北京同仁医院眼科	眼科	羊膜移植联合带结膜瓣自体角膜缘移植及丝裂霉素C治疗多次复发性翼状胬肉
戴荣平	中国协和医科大学	中华眼科杂志	人工眼的研究现状及发展前景
戴虹	北京医院眼科	中华眼科杂志	眼科手术后斜视和复视的临床分析
戴達厲	，中國上海市嘉定區中醫醫院眼科	国际眼科杂志	復發性翼狀胬肉切除并自體幹細胞移植療效觀察
房建壮	荣成市第二人民医院	眼外伤职业眼病杂志	鱼舱内鳀鱼腐败气体中毒的眼部表现
才娜	中国医科大学附属第一医院眼科	国际眼科杂志	眼内手术后病毒性角膜炎临床分析
才让当周	海西州人民医院眼科	眼外伤职业眼病杂志	白内障患者非手术眼发生碘伏过敏性角结膜炎16例报告
承伟	江苏省张家港市第一人民医院眼科	中国眼耳鼻喉科杂志	丝裂霉素C联合20%乙醇分离翼状胬肉切除术的临床观察
承伟	江苏省张家港市第一人民医院眼科	临床眼科杂志	乙醇分离法联合丝裂霉素C治疗翼状胬肉疗效观察
接传红	中国中医科学院眼科医院	中国中医眼科杂志	川椒方治疗过敏性结膜炎的临床观察
接英	首都医科大学附属北京同仁医院	中华眼科杂志	重视调控眼免疫稳定的调节性T细胞
接英	首都医科大学同仁医院眼科中心	中国实用眼科杂志	自体骨髓间充质干细胞移植改善重度眼表损伤临床观察
文峰	中山大学中山眼科中心	中华眼底病杂志	系统性红斑狼疮并发视网膜静脉阻塞的临床分析
文智伟	湖南省永州市人民医院眼科	眼外伤职业眼病杂志	翼状胬肉不同术式效果的对比观察
文智伟	永州市眼科研究所	眼外伤职业眼病杂志	翼状胬肉术后滴用重组人表皮生长因子的疗效
方健	上海交通大学附属第六人民医院眼科	中华实验眼科杂志	翼状胬肉胶原变化的研究
方华	湖北医药学院附属太和医院眼科	国际眼科杂志	新型硅胶泪道引流管在治疗泪道阻塞中的应用
方向东	湖北省应城市中医医院眼科	中国中医眼科杂志	改良翼状胬肉切除术的临床体会
方向阳	安徽省黄山市解放军532医院眼科	中国实用眼科杂志	乙醇松解翼状胬肉切除联合角膜缘上皮移植的疗效观察
方旺	深圳市儿童医院眼科	临床眼科杂志	FK506在实验性过敏性结膜炎局部免疫调控的作用
方旺	深圳市儿童医院眼科	国际眼科杂志	FK506对实验性过敏性结膜炎细胞因子表达的影响
方欣	安徽省淮南市晨光眼科医院	临床眼科杂志	自体角膜缘干细胞移植联合准分子激光治疗性角膜切削术治疗翼状胬肉的临床观察
方玉华	江汉油田总医院眼科	国际眼科杂志	生物冻干羊膜移植在复发性翼状胬肉手术中的应用观察
方秋云	广州医学院第二附属医院眼科	中华眼科杂志	翼状胬肉显微手术方法及其疗效观察
方秋云	广州医学院第二附属医院眼科	中国实用眼科杂志	翼状胬肉根治手术预防复发的效果观察
方芳	中国湖北省宜昌市中心人民医院视光学专科	国际眼科杂志	LASIK手术与翼状胬肉相互影响的探讨
施天严	浙江省缙云县人民医院眼科	眼外伤职业眼病杂志	丝裂霉素C在首次复发性翼状胬肉中的应用
施明光	温州医学院附属第二医院眼科	临床眼科杂志	翼状胬肉术后的角膜地形图改变
施炜	江苏省中医院眼科中心	临床眼科杂志	不同激素浓度对预防翼状胬肉术后复发的临床观察
施瑜劲	福建泉州市儿童医院泉州北京同仁眼科中心	中国实用眼科杂志	翼状胬肉保留球结膜根治性切除联合应用丝裂霉素的疗效探讨
施瑜劲	中国福建省泉州市儿童医院眼科	国际眼科杂志	两种翼状胬肉手术方式对角膜曲率影响的临床研究
施若菲	上海交通大学附属瑞金医院皮肤科	中华实验眼科杂志	异位性皮炎的眼部并发症
施虹	浙江省桐乡市第二人民医院眼科	中国眼耳鼻喉科杂志	泪小管切开治疗泪小管炎伴结石13例
时亚新	漯河市中心医院	眼外伤职业眼病杂志	单纯羊膜移植和联合角膜缘移植治疗翼状胬肉
昌宏发	西藏军区总医院眼科	眼外伤职业眼病杂志	高原低气压环境相关特殊眼外伤的防治
明国英	广东省三水市人民医院眼科	中国实用眼科杂志	自体和异体角膜缘联合羊膜移植治疗难治翼状胬肉的研究
明春光	中国内蒙古乌兰浩特市医院眼科	国际眼科杂志	特发性持续性眼睑痉挛1例
明玥	武汉艾格眼科医院眼表与眼整形科	国际眼科杂志	治疗性软性角膜接触镜在翼状胬肉手术中的应用和评价
易敬林	江西省人民医院眼科	中国实用眼科杂志	保存人羊膜移植治疗难治性眼表疾病的临床效果
易笃友	永州职业技术学院附属医院	中国中医眼科杂志	平阳霉素在复发性翼状胬肉中的临床应用
易笃友	永州职业技术学院附属医院眼科	国际眼科杂志	改良式角膜缘干细胞移位术治疗早期翼状胬肉的临床研究
晁明伦	驻马店市中心医院	眼外伤职业眼病杂志	重组人表皮生长因子在翼状胬肉术后的应用
晋秀明	浙江省温州医学院附属眼视光医院	中华实验眼科杂志	翼状胬肉患者术前和术后泪液功能的临床研究
晏兴云	中国四川省遂宁市中心医院眼科	国际眼科杂志	翼状胬肉不同术式治疗后1a内复发率的比较
晏晓明	北京大学第一医院眼科	中华眼科杂志	眼瘢痕性类天疱疮病例的回顾性分析
晏晓明	北京大学第一医院眼科	中华眼科杂志	抗过敏滴眼液对体外培养的人角膜上皮细胞的毒性作用
晏理红	新疆生产建设兵团农六师奇台医院眼科	国际眼科杂志	高海拔地区少数民族翼状胬肉治疗的临床观察
晏雪莹	华中科技大学同济医学院附属协和医院眼科	中华实验眼科杂志	来氟米特活性代谢物A77 1726对翼状胬肉成纤维细胞增生的影响
晏雪莹	华中科技大学同济医学院附属协和医院眼科	中华实验眼科杂志	β-NGF对人翼状胬肉成纤维细胞增生的影响
景红	河南大学淮河医院眼科	中华实验眼科杂志	DNA氧化损伤在翼状胬肉发病中的作用
智慧敏	甘肃省兰州市第一人民医院	中国眼耳鼻喉科杂志	自体角膜缘干细胞移植治疗眼表面疾病
智淑平	徐州市中心医院眼科	中国实用眼科杂志	丝裂霉素C用于翼状胬肉自体角膜缘干细胞移植的临床分析
曲玉环	广西壮族自治区民族医院眼科	国际眼科杂志	自体血清结膜下注射治疗过敏性结膜炎的临床研究
曲申	同济大学附属同济医院眼科	眼外伤职业眼病杂志	前段光学相干断层成像测量翼状胬肉术后结膜植片厚度的临床研究
曲静涛	沈阳军区总医院眼科	中国实用眼科杂志	三重眼表解剖屏障重建术防治翼状胬肉复发四年前瞻性研究
曹东	陕西省宝鸡市解放军第三医院眼科	中华眼视光学与视觉科学杂志	眼毛囊异位症合并睑板腺囊肿1例
曹丹	中山大学中山眼科中心眼科学国家重点实验室	中华眼科杂志	透明质酸钠对兔含苯扎氯铵溴莫尼定眼表毒性保护作用的研究
曹亮	南通市第一人民医院眼科	中华实验眼科杂志	纤维蛋白胶在兔眼翼状胬肉自体结膜瓣转移手术中的应用
曹伯泉	南通医学院第二附属医院眼科江苏南通	眼科	低温保存人羊膜移植在重建眼表结构中的临床应用
曹伯泉	南通医学院第二附属医院眼科	眼科	单层或多层羊膜移植治疗眼表疾病
曹兰	新疆昌吉州人民医院眼科	临床眼科杂志	丝裂霉素C眼科应用引起巩膜溶解临床报告
曹勤	广西壮族自治区北海市中医院眼科	中国眼耳鼻喉科杂志	平阳霉素预防翼状胬肉术后复发的临床观察
曹哲瑶	中国医科大学附属盛京医院眼科	国际眼科杂志	蒲地蓝消炎口服液治疗流行性角结膜炎的临床疗效
曹坤	河南省光山县妇幼保健院眼科	中华实验眼科杂志	沙眼性角膜瘢痕合并老年性白内障人工晶状体植入32例手术体会
曹奎	绵阳万江眼科医院眼科	国际眼科杂志	带蒂结膜瓣移植联合MMC治疗翼状胬肉合并结膜松弛症
曹婷	武汉大学人民医院眼科	国际眼科杂志	角膜缘血管网切断联合生物羊膜移植治疗角膜新生血管
曹小鹏	中国新疆维吾尔自治区乌鲁木齐市	国际眼科杂志	翼状胬肉标准化手术治疗的疗效
曹恒	中国湖北省荆门市第二人民医院眼科	国际眼科杂志	新鲜羊膜移植联合治疗性软性角膜接触镜在治疗翼状胬肉中的应用
曹文红	首都医科大学附属北京儿童医院眼科	中国斜视与小儿眼科杂志	Ritleng 泪道插管术治疗结膜炎导致的儿童继发性泪道阻塞疗效观察
曹文红	首都医科大学附属北京儿童医院眼科	中华实验眼科杂志	先天性阔睑一例
曹晋	中国河南省固始县人民医院眼科	国际眼科杂志	巩膜桥加压掩盖法治疗复发性翼状胬肉22例
曹晓滨	上海市杨浦中心医院眼科	眼外伤职业眼病杂志	翼状胬肉切除术后角膜散光改善的研究
曹晓滨	上海市杨浦区中心医院眼科	眼外伤职业眼病杂志	翼状胬肉手术标本中MMP-2及MMP-9的表达和意义
曹晓滨	上海市杨浦区中心医院眼科	临床眼科杂志	翼状胬肉切除联合羊膜或自体角膜缘干细胞移植术的临床应用研究
曹晓滨	上海市杨浦区中心医院	眼外伤职业眼病杂志	翼状胬肉切除术后角膜地形图改变
曹月红	浙江省金华市人民医院眼科	中国眼耳鼻喉科杂志	翼状胬肉合并结膜松弛症眼表重建的临床观察
曹洪欣	上海市杨浦区中心医院眼科	中华实验眼科杂志	翼状胬肉三种不同术式的疗效分析
曹瑾	武汉大学人民医院眼科	临床眼科杂志	春季卡他性结膜炎的药物治疗疗效观察
曹端荣	暨南大学附属深圳市眼科医院	中国实用眼科杂志	新生儿急性细菌性结膜炎10年致病菌变迁
曹端荣	深圳暨南大学附属深圳市眼科医院	中国斜视与小儿眼科杂志	新生儿淋菌性结膜炎致病菌10年药物敏感性的变迁
曹端荣	中国广东省深圳市宝安区人民医院眼科	国际眼科杂志	Survivin蛋白和Fas蛋白在原发性翼状胬肉中的表达及其相关性研究
曹美凤	上海交通大学附属第一人民医院眼科	中华实验眼科杂志	视网膜脱离术后植入物外露致低眼压一例
曹芃	中国新疆维吾尔自治区乌鲁木齐市	国际眼科杂志	翼状胬肉标准化手术治疗的疗效
曹诗红	禹州市人民医院	眼外伤职业眼病杂志	改良自体角膜干细胞移植术治疗翼状胬肉初步观察
曹阳	同济医科大学附属协和医院眼科	中华实验眼科杂志	春季结膜炎患者血清中的IL-1β及IL-8
曹雪川	云南省中医医院	中国中医眼科杂志	自体角膜缘干细胞移植术联合中药治疗翼状胬肉疗效观察
曾思明	广西壮族自治区人民医院眼科	国际眼科杂志	眼科显微手术技能培训模式探讨
曾招荣	广西医科大学第四附属医院	眼外伤职业眼病杂志	新鲜羊膜移植治疗复发性翼状胬肉
曾明兵	广州医学院第二附属医院眼科	中国实用眼科杂志	螨脱敏治疗变应性结膜炎的观察
曾昭荣	广东省三水市人民医院眼科	中国实用眼科杂志	自体和异体角膜缘联合羊膜移植治疗难治翼状胬肉的研究
曾曼	大连医科大学附属第一医院眼科	国际眼科杂志	球结膜瓣转移结合丝裂霉素C治疗翼状胬肉
曾木圣	中山大学肿瘤防治中心	中华眼科杂志	翼状胬肉上皮细胞p53蛋白的表达及其功能状态的研究
曾水清	华中科技大学同济医学院附属协和医院眼科	临床眼科杂志	儿童过敏性结膜炎和过敏性鼻炎的关系
曾波	广州军区武汉总医院眼科	国际眼科杂志	二期羟基磷灰石义眼台早期植入临床观察
曾洁	宁夏石嘴山市第二人民医院眼科	眼科	荧光素钠染色条致双眼角结膜过敏一例
曾涛	玉溪市第一人民医院眼科	中国中医眼科杂志	新生儿淋菌性结膜炎的疗效观察
曾益新	中山大学肿瘤防治中心	中华眼科杂志	翼状胬肉上皮细胞p53蛋白的表达及其功能状态的研究
曾益群	解放军第171医院	眼外伤职业眼病杂志	羊膜移植治疗复发性翼状胬肉(附10例报告)
曾益群	解放军第一七一医院	眼外伤职业眼病杂志	丝裂霉素C在翼状胬肉手术中的应用
朱丹	政和县医院	眼外伤职业眼病杂志	生物羊膜治疗翼状胬肉的临床观察
朱丽贞	山东省济南市中心医院眼科	临床眼科杂志	两种方法保存羊膜联合自体角膜缘移植治疗复发性翼状胬肉
朱云	华中科技大学同济医学院附属协和医院眼科	临床眼科杂志	姜黄素抑制人血管内皮细胞增殖的研究
朱伟林	上海市浦东新区人民医院眼科	中国实用眼科杂志	翼状胬肉手术对改善角膜散光及曲率的临床研究
朱俊东	中国湖南省郴州市第一人民医院眼科	国际眼科杂志	Avastin治疗复发性翼状胬肉的临床研究
朱冬梅	郑州人民医院卓美眼科	眼外伤职业眼病杂志	翼状胬肉术后巩膜并发症的临床分析及治疗观察
朱凯	绍兴市人民医院	眼外伤职业眼病杂志	羊膜移植与角膜缘干细胞移植治疗翼状胬肉
朱华丽	核工业四一六医院眼科	国际眼科杂志	翼状胬肉术后90Srβ射线敷贴治疗疗效观察及复发相关因素分析
朱卓颖	解放军101医院眼科	临床眼科杂志	自体角膜缘上皮移植联合贝复舒治疗翼状胬肉的疗效观察
朱哲	中山大学中山眼科中心中山大学眼科学国家重点实验室	中华眼科杂志	翼状胬肉组织中血管拟态的初步研究
朱哲	中山大学眼科学国家重点实验室	中华实验眼科杂志	CD34在翼状胬肉中表达的意义
朱大强	郑州纺织机械厂职工医院眼科	眼外伤职业眼病杂志	自体角膜缘干细胞移植联合丝裂霉素C治疗翼状胬肉
朱婷	南京大学医学院临床学院南京军区南京总医院眼科	中华实验眼科杂志	激光共焦显微镜与组织病理学对翼状胬肉组织中微血管密度研究的比较
朱婷婷	无锡市第二人民医院眼科	中华实验眼科杂志	人乳头状瘤病毒在翼状胬肉发病机制中的作用
朱学军	福建医科大学附属一院眼科	中国实用眼科杂志	系统性红斑狼疮患者眼表损害及相关抗体检测
朱小丽	中国广东省深圳市眼科医院小儿眼科	国际眼科杂志	盐酸氮卓斯汀滴眼液治疗儿童变态反应性结膜炎的疗效
朱希希	温州医学院附属眼视光医院	中华眼视光学与视觉科学杂志	翼状胬肉对角膜生物力学特性的影响
朱建刚	江苏省张家港市第一人民医院眼科	临床眼科杂志	乙醇分离法联合丝裂霉素C治疗翼状胬肉疗效观察
朱建刚	江苏省张家港市第一人民医院眼科	中国眼耳鼻喉科杂志	丝裂霉素C联合20%乙醇分离翼状胬肉切除术的临床观察
朱建芳	固始县人民医院	眼外伤职业眼病杂志	结膜瓣转移联合低浓度丝裂霉素C治疗翼状胬肉
朱彦霞	连云港市第二人民医院眼科	眼外伤职业眼病杂志	海水盐场职工翼状胬肉患病率分析及手术治疗的临床观察
朱志忠	上海和平眼科医院	中国实用眼科杂志	环孢素A在眼表移植和角膜炎症中的应用
朱思强	浙江省平阳县人民医院	中华眼视光学与视觉科学杂志	216例频繁瞬目儿童屈光状态及病因分析
朱慧娟	浙江省绍兴市人民医院眼科	中国实用眼科杂志	翼状胬肉切除术中与术后应用丝裂霉素C的比较
朱慧娟	浙江省绍兴市人民医院眼科	眼科	翼状胬肉切除术中丝裂霉素C的应用
朱承华	江苏省人民医院眼科	国际眼科杂志	转化生长因子-β与翼状胬肉
朱承华	中国南京医科大学附属第一医院眼科	国际眼科杂志	盐酸洛美沙星眼凝胶临床生物等效性试验
朱振龙	河北医科大学附属第一医院病理科	国际眼科杂志	翼状胬肉发病机制及治疗研究进展
朱捷	福建省南平市第一医院眼科	中国斜视与小儿眼科杂志	新生儿淋菌性结膜炎的临床分析
朱敏	佛山市第一人民医院眼科	眼科	人羊膜移植治疗翼状胬肉等眼表疾病的临床观察
朱敏	中国广东省佛山市第一人民医院眼科	国际眼科杂志	翼状胬肉角膜缘干细胞移植与羊膜移植的比较
朱敏	广东省佛山市第一人民医院眼科	临床眼科杂志	急性结膜炎痊愈后泪膜功能的变化
朱文卿	复旦大学附属眼耳鼻喉科医院眼科	中华眼科杂志	激光共聚焦显微镜观察春季角结膜炎患者的角膜形态变化
朱斌良	中国陕西省西安市眼科医院	国际眼科杂志	新鲜羊膜移植治疗复发性翼状胬肉30例
朱斯平	中山大学中山眼科中心	国际眼科杂志	复发性与原发性翼状胬肉广泛切除联合羊膜移植治疗观察
朱明娟	中国青海省四宁市	国际眼科杂志	自体干细胞移植治疗翼状胬肉50例疗效观察
朱明娟	青海省中医院眼科	临床眼科杂志	显微自体干细胞移植治疗50例翼状胬肉临床疗效观察
朱映芳	湘南学院附属医院眼科	国际眼科杂志	不同手术方式翼状胬肉切除术后巩膜并发症的临床研究
朱晓宇	中国江苏省扬州市第一人民医院眼科	国际眼科杂志	逆行撕剥术治疗初发翼状胬肉的临床观察
朱晓宇	上海市吴泾医院眼科	眼外伤职业眼病杂志	生物羊膜或结膜移植治疗翼状胬肉的效果比较
朱晓波	中山大学中山眼科中心	中国实用眼科杂志	翼状胬肉切除对泪液功能的影响
朱晶	中国湖北省武汉市第一医院眼科	国际眼科杂志	银杏叶提取物对体外培养翼状胬肉成纤维细胞增殖的抑制作用
朱朝花	广东医学院附属医院眼科	国际眼科杂志	翼状胬肉组织中Bcl-2和ICAM-1的表达
朱杰	甘肃省敦煌市医院	临床眼科杂志	高原地区翼状胬肉显微手术治疗疗效观察
朱格非	深圳市人民医院暨南大学医学院二附院	眼科	新鲜羊膜移植治疗眼化学伤和翼状胬肉
朱洪芬	，中國雲南省南華縣人民醫院五官科	国际眼科杂志	用點必舒舆頭孢噻肟鈉治療新生兒淋菌性結膜炎4例
朱燕玲	广东省台山市人民医院眼科	临床眼科杂志	冷冻保存羊膜移植治疗眼表疾病疗效观察
朱爱林	江苏省淮安市楚州区上河镇卫生院	眼外伤职业眼病杂志	自体角膜缘移植联合应用MMC治疗翼状胬肉
朱瑞	宿迁市钟吾医院眼科	眼外伤职业眼病杂志	萘敏维联合微量地塞米松在翼状胬肉围手术期应用
朱璇	中国江苏省高邮市人民医院眼科	国际眼科杂志	自体结膜在翼状胬肉手术治疗中的美容效果观察
朱秀梅	山东省菏泽市第三人民医院眼科	临床眼科杂志	新鲜羊膜移植治疗翼状胬肉的临床观察
朱秀萍	西安市第一医院眼病研究室	中华实验眼科杂志	抗腺病毒3型单克隆抗体的制备及临床应用研究
朱秀萍	中国西安市眼科研究所	国际眼科杂志	丫啶橙荧光染色结膜印迹细胞定量检测干燥性角结膜炎
朱秀萍	陕西省眼科研究所	国际眼科杂志	衣原体单克隆抗体胶体金法测定沙眼衣原体
朱美玲	安徽医科大学附属第一医院眼科	中国实用眼科杂志	小牛血去蛋白提取物眼凝胶治疗角膜上皮缺损的多中心临床研究
朱美玲	安徽医科大学附属医院眼科	眼外伤职业眼病杂志	角膜缘上皮联合羊膜移植治疗眼表疾病的研究
朱苏东	中国中医科学院江苏分院眼科	国际眼科杂志	Vogt-小柳-原田综合征的临床误诊分析
朱莉	上海和平眼科医院	中国实用眼科杂志	环孢素A在眼表移植和角膜炎症中的应用
朱虹	中國西安兵器工業204醫院眼科	国际眼科杂志	自體角膜缘上皮移植聯合缘裂霉素C治瘵翼狀胬肉的臨床觀察
朱虹	天津市眼科医院	临床眼科杂志	手术切除联合贝复舒治疗翼状胬肉的疗效观察
朱豫	郑州大学第一附属医院眼科	眼外伤职业眼病杂志	羊膜移植联合丝裂霉素C治疗复发性翼状胬肉疗效研究
朴天华	黑龙江牡丹江医学院红旗医院	中国实用眼科杂志	翼状胬肉切除术后锶90贴敷平阳霉素注射疗效观察
朴天华	牡丹江医学院红旗医院眼病中心	眼外伤职业眼病杂志	翼状胬肉术后角膜穿孔一例
权彦龙	西安交通大学医学院第二附属医院眼科	国际眼科杂志	带蒂结膜瓣转移联合丝裂霉素C治疗复发性翼状胬肉的临床研究
权菊玲	中国陕西省渭南市第二医院眼科中心	国际眼科杂志	手术显微镜下翼状胬肉切除联合丝裂霉素C应用98例疗效观察
李一维	广州市第二人民医院眼科	眼外伤职业眼病杂志	误滴502胶水致眼部损伤
李世英	中国青海省四宁市	国际眼科杂志	自体干细胞移植治疗翼状胬肉50例疗效观察
李东侃	厦门大学附属厦门眼科中心	国际眼科杂志	翼状胬肉组织Caveolin-1,E-cadherin和P63的表达
李中然	临颍县人民医院	眼外伤职业眼病杂志	新鲜羊膜移植治疗复发性翼状胬肉的效果观察
李丽	兰州医学院第一附属医院	眼外伤职业眼病杂志	角膜缘干细胞移植或羊膜移植治疗翼状胬肉
李云峰	哈尔滨爱尔眼科医院	临床眼科杂志	翼状胬肉面积与角膜散光关系的分析研究
李云川	昆明市第一人民医院	眼外伤职业眼病杂志	羊膜移植丝裂霉素治疗复发性翼状胬肉
李亚楠	中国河北省沧州市	国际眼科杂志	河北省沧州城区6~14岁学龄儿童眼病现况调查
李亚波	丹阳市儿童医院	眼外伤职业眼病杂志	单纯性翼状胬肉两种手术方法的疗效比较
李伟军	广西南宁铁路医院	眼外伤职业眼病杂志	眼科手术后角膜缘溃疡临床分析(附3例报告)
李传宝	广西医科大学第一附属医院眼科中心	中国实用眼科杂志	翼状胬肉术后诊断为血友病A一例
李俭	平顶山市第二人民医院	眼外伤职业眼病杂志	自体角膜缘干细胞移植治疗翼状胬肉
李儒华	郧阳医学院附属人民医院眼科	国际眼科杂志	逆行撕离联合原位自体结膜瓣旋转移植治疗翼状胬肉64例
李元福	深圳市梅沙医院	中国实用眼科杂志	IL-1 α在初发与复发性翼状胬肉中的异常表达
李元福	盐田区人民医院眼科	眼外伤职业眼病杂志	初发胬肉与复发胬肉中ⅠL-1α和VEGFR-1的表达相关性研究
李元龙	安徽省马鞍山市马钢医院眼科	临床眼科杂志	羊膜移植治疗翼状胬肉临床疗效观察
李兆瑞	南华大学附属第一医院眼科	国际眼科杂志	原发性翼状胬肉发病机制和治疗新进展
李兰	昆明市第一人民医院	眼外伤职业眼病杂志	羊膜移植丝裂霉素治疗复发性翼状胬肉
李兰娇	重庆医科大学第二附属医院眼科	中国实用眼科杂志	两种矫正退行性下睑外翻手术方法效果比较
李兵	辽宁医学院附属第一医院眼科	国际眼科杂志	羊膜移植和自体角膜缘干细胞移植治疗翼状胬肉
李冀	邯郸眼科医院眼科	国际眼科杂志	应用准分子激光角膜切削术治疗翼状胬肉的临床观察
李冀	河北邯郸市眼科医院眼科	中国实用眼科杂志	翼状胬肉切除联合准分子激光治疗性角膜切削术与角膜缘干细胞移植术疗效对比观察
李冀	中国河北省邯郸市眼科医院	国际眼科杂志	翼状胬肉手术治疗研究进展
李军	山东省枣庄矿业集团中心医院眼科	临床眼科杂志	改良睑缘后退术治疗沙眼性上睑内翻倒睫疗效观察
李军	中国人民解放军113医院眼科	国际眼科杂志	带蒂球结膜瓣转移术治疗翼状胬肉180例的疗效观察
李军	大连市第三人民医院眼科	中国实用眼科杂志	平阳霉素结膜下注射治疗复发性翼状胬肉疗效观察
李军营	喀什农三师医院眼科	眼外伤职业眼病杂志	自体角膜缘干细胞移植治疗翼状胬肉148例
李冬	北京煤炭总医院眼科	临床眼科杂志	120例儿童异常瞬目症的临床分析
李冬梅	首都医科大学附属北京同仁医院北京同仁眼科中心	眼外伤职业眼病杂志	保留眼球的改良美容性全结膜瓣遮盖术
李冬梅	海军青岛401医院眼科	眼外伤职业眼病杂志	不同部位角膜干细胞移植治疗翼状胬肉的疗效分析
李冰	中国山西省眼科医院角膜科	国际眼科杂志	巩膜暴露法联合术中应用丝裂霉素C治疗双头翼状胬肉
李冰	山西省眼科医院	中国斜视与小儿眼科杂志	儿童泡性眼炎病因分析及治疗
李凤仙	山西焦煤集团古交矿区总医院	中国实用眼科杂志	小儿频繁瞬目的临床分析
李刚	海军总医院眼科	国际眼科杂志	自体角膜缘干细胞移植联合丝裂霉素C治疗活动期翼状胬肉
李剑洪	义乌市中心医院	中华眼视光学与视觉科学杂志	原发性翼状胬肉对泪膜稳定性的影响
李劼	中国湖北省大冶市人民医院眼科	国际眼科杂志	角膜接触镜在翼状胬肉切除术的应用评价
李劼	中国湖北省大冶市人民医院眼科	国际眼科杂志	翼状胬肉切除联合角膜干细胞移植术中两种缝合方法对比研究
李勇	华中科技大学同济医学院附属孝感医院眼科	国际眼科杂志	深部固定术治疗先天性内翻倒睫的临床观察
李勇	华中科技大学同济医学院附属孝感医院眼科	国际眼科杂志	5-FU联合自体角膜缘干细胞移植治疗复发性翼状胬肉
李勇	中国上海市长宁区中心医院眼科	国际眼科杂志	羊膜移植治疗复发性翼状胬肉32例
李勇	华中科技大学同济医学院附属孝感医院眼科	国际眼科杂志	角膜缘干细胞移植及羊膜移植联合丝裂霉素C治疗复发性翼状胬肉
李勋赤	中山大学中山眼科中心	中国实用眼科杂志	碱性成纤维细胞生长因子治疗Sjogren综合征和非Sjogren水液缺乏性干眼疗效观察
李华秀	山东省滨州市中心医院眼科	中国实用眼科杂志	翼状胬肉切除角膜缘重建术后无菌性巩膜融解
李博	鄂州市中心医院眼科	眼外伤职业眼病杂志	翼状胬肉两种不同术式的临床观察
李博	解放军第三医院眼科	国际眼科杂志	翼状胬肉切除术中应用丝裂霉素C联合自体角膜缘干细胞移植的疗效分析
李占玲	中国陕西省扶风县人民医院眼科	国际眼科杂志	羊膜移植治疗眼表疾病的疗效观察
李厚勇	复旦大学附属眼耳鼻喉科医院耳鼻喉科	中国眼耳鼻喉科杂志	不同螨致敏原对变应性鼻炎患者生活质量的影响
李友谊	泸州医学院附属医院眼科	中国实用眼科杂志	2011年泸州市40岁及以上人群翼状胬肉患病率调查
李发忠	中国广东省梅县人民医院眼科	国际眼科杂志	羊膜移植联合保留球结膜翼状胬肉切除术的临床研究
李发忠	广东省梅县人民医院五官科	中华眼科杂志	广东省梅县盲和低视力流行病学调查
李同庆	黔南州人民医院	眼外伤职业眼病杂志	下方带蒂角膜缘上皮移植治疗翼状胬肉
李国培	广东省佛山市第一人民医院眼科	临床眼科杂志	急性结膜炎痊愈后泪膜功能的变化
李国星	温州医学院附属眼视光医院白内障专科	中华眼视光学与视觉科学杂志	衣氏放线菌致结膜感染1例
李城	宁夏石嘴山市第二人民医院眼科	眼科	荧光素钠染色条致双眼角结膜过敏一例
李培凤	武汉市第一医院眼科	临床眼科杂志	翼状胬肉切除联合应用丝裂霉素 C 与自体结膜移植治疗翼状胬肉的 Meta 分析
李培高	山东省烟台经济技术开发区医院	临床眼科杂志	刮除上皮联合接触镜治疗点状角膜炎1例
李士成	盐城市城区人民医院眼科	中国中医眼科杂志	冷冻加中药在治疗春季结膜炎中的疗效观察
李奇志	安徽省安庆宜城医院眼科	临床眼科杂志	综合治疗翼状胬肉的临床观察
李婷	遵义医学院第五附属	国际眼科杂志	翼状胬肉上结膜反向移植联合生物羊膜治疗复发性翼状胬肉
李婷	遵义医学院第五附属珠海医院眼科	眼外伤职业眼病杂志	两种翼状胬肉结膜移植手术美容效果观察
李媚	中山大学中山眼科中心眼科学国家重点实验室	中华眼科杂志	透明质酸钠对兔含苯扎氯铵溴莫尼定眼表毒性保护作用的研究
李学喜	泉州市解放军第180医院眼科中心	中国实用眼科杂志	角膜缘干细胞移行遮盖法切除翼状胬肉
李学喜	中国人民解放军第一八○医院眼科	国际眼科杂志	滑行移植自体角膜缘干细胞联合丝裂霉素C治疗翼状胬肉
李学喜	解放军第180医院眼科中心	国际眼科杂志	两种翼状胬肉切除手术的同体异眼比较
李学喜	解放军第180医院眼科中心	国际眼科杂志	角膜缘干细胞滑行移植法切除翼状胬肉
李学民	北京大学第三医院眼科	中华眼科杂志	泪道栓塞术治疗干眼症的临床效果
李学民	北京大学第三医院眼科中心	中华眼科杂志	翼状胬肉术后结膜印记细胞学及临床疗效观察
李守英	商河县中医医院眼科	中国中医眼科杂志	左眼角巩膜长期存留异物1例
李宏科	新疆乌苏第15医院眼科	眼科	FGI-A型沙眼治疗仪治疗进行期沙眼43例
李宗美	兰州军区乌鲁木齐总医院	中华实验眼科杂志	沙眼衣原体两种基因诊断方法的比较
李宗美	兰州军区乌鲁木齐总医院眼科	中华实验眼科杂志	倍诺喜滴眼液致双眼严重角膜损害一例
李宝储	沈阳军区总医院眼科	中国实用眼科杂志	三重眼表解剖屏障重建术防治翼状胬肉复发四年前瞻性研究
李家琳	安徽省黄山市解放军532医院眼科	中国实用眼科杂志	乙醇松解翼状胬肉切除联合角膜缘上皮移植的疗效观察
李家璋	中国湖北省恩施州中心医院眼科	国际眼科杂志	自体角膜缘干细胞移植联合MMC对翼状胬肉疗效的Meta分析
李家臣	河南省眼科研究所	中华实验眼科杂志	盐酸左氧氟沙星滴眼液治疗细菌性结膜炎及角膜炎随机双盲对照临床研究
李富华	天津市眼科医院	中华实验眼科杂志	青光眼术后巨大结膜囊肿一例
李富华	天津医科大学眼科临床学院、天津市眼科医院	中华眼底病杂志	后巩膜炎继发急性浅前房一例
李富华	天津市眼科学与视觉科学重点实验室	中国实用眼科杂志	糖皮质激素在流行性角结膜炎治疗中应用分析
李小丹	重庆医科大学附属第一医院眼科	中国实用眼科杂志	Sj(o)gren综合征发病机制及治疗进展
李小兵	福建厦门大学医院眼科	中国实用眼科杂志	睑板腺癌误诊1例
李小影	遵义医学院第五附属珠海医院眼科	眼外伤职业眼病杂志	两种翼状胬肉结膜移植手术美容效果观察
李小明	阆中市人民医院	眼外伤职业眼病杂志	结膜移植联合平阳霉素治疗复发性翼状胬肉
李岩	中国人民解放军113医院眼科	国际眼科杂志	带蒂球结膜瓣转移术治疗翼状胬肉180例的疗效观察
李岩	宿迁市钟吾医院眼科	眼外伤职业眼病杂志	萘敏维联合微量地塞米松在翼状胬肉围手术期应用
李岱	中山大学中山眼科中心中山大学眼科学国家重点实验室	国际眼科杂志	汉防己甲素抑制翼状胬肉成纤维细胞增殖的研究
李岱	中山大学中山眼科中心	中国实用眼科杂志	正常球结膜与翼状胬肉成纤维细胞生长增殖状况的对比观察
李岱	中山大学中山眼科中心	中华实验眼科杂志	汉防己甲素对翼状胬肉成纤维细胞抑制作用的实验研究
李峻岭	安徽医科大学附属医院眼科	眼外伤职业眼病杂志	角膜缘上皮联合羊膜移植治疗眼表疾病的研究
李崇林	中国上海市徐汇区大华医院眼科	国际眼科杂志	改良逆行撕剥术联合自体结膜瓣移植治疗翼状胬肉的临床观察
李巧云	山东省金乡县人民医院	眼外伤职业眼病杂志	角膜异物长期误诊误治三例报告
李常榮	中國吉林省四平市中心醫院眼科	国际眼科杂志	自體眼表移植術治瘵翼狀胬肉
李平华	重庆医科大学附属第一医院眼科	国际眼科杂志	基质金属蛋白酶及其组织抑制剂与白内障
李康翔	福建省邵武市拿口中心卫生院	眼外伤职业眼病杂志	双向剥离加结膜遮盖治疗翼状胬肉
李建东	河北省武强县医院眼科	中华实验眼科杂志	武强县小学生沙眼流行病学调查
李建军	西电集团医院眼科	国际眼科杂志	配戴角膜接触镜并发巨乳头结膜炎患者112例临床分析
李建军	首都医科大学附属北京同仁医院	眼科	北京市城乡限定人群白内障手术负荷量及术后视力评价
李建军	首都医科大学北京同仁眼科中心	中华眼科杂志	北京特定地区翼状胬肉患病率的流行病学调查
李建南	湖南博雅眼科医院	国际眼科杂志	绷带式角膜接触镜在翼状胬肉切除合并结膜移植术的应用
李建学	中国陕西省榆林市第二医院眼科	国际眼科杂志	翼状胬肉手术中应用羊膜移植联合丝裂霉素48眼
李建桥	山东大学齐鲁医院眼科	中国实用眼科杂志	坏死性巩膜炎1例
李建玲	河北省武强县文教局	中华实验眼科杂志	武强县小学生沙眼流行病学调查
李建疆	浙江省平湖市眼科医院	眼外伤职业眼病杂志	角膜缘干细胞移植治疗翼状胬肉
李强	暨南大学附属深圳市眼科医院角膜病科	国际眼科杂志	羊膜移植术治疗重症春季卡他性结膜炎的疗效分析
李强	陕西省宝鸡市解放军第三医院眼科	中华眼视光学与视觉科学杂志	眼毛囊异位症合并睑板腺囊肿1例
李强	广州市花都区人民医院眼科	临床眼科杂志	翼状胬肉切除术后应用贝复舒与爱丽滴眼液疗效对比观察
李彬	首都医科大学北京同仁眼科中心	中华眼科杂志	结膜鳞状细胞癌侵犯眼球内一例
李彬	北京市眼科研究所	眼科	翼状胬肉组织病理学研究及相关因子的检测
李彬斌	暨南大学附属第一医院眼科	中华实验眼科杂志	丝裂霉素C对翼状胬肉成纤维细胞膜通透性及超微结构的影响
李志刚	海口，海南省人民医院眼科	中华眼科杂志	海南省两县(市)翼状胬肉患病率的调查
李志英	三峡大学医学院附属医院，湖北宜昌	眼科	羊膜移植治疗大泡性角膜病变的临床应用
李思媛	省部共建国家重点实验室培育基地	中华实验眼科杂志	免疫刺激剂CpG ODN防治烟曲霉菌引起的变态反应性结膜炎的实验研究
李恒	中国四川省遂宁市中心医院眼科	国际眼科杂志	角膜缘干细胞移植联合贝复舒眼液治疗复发性翼状胬肉的临床观察
李惠荣	甘肃省第二人民医院眼科	临床眼科杂志	角膜缘血管切断术联合丝裂霉素治疗角膜新生血管效果观察
李慧平	宁夏回族自治区人民医院宁夏眼科医院	国际眼科杂志	宁夏地区翼状胬肉患病率的流行病学调查
李慧燕	安徽省蒙城县第二人民医院	临床眼科杂志	翼状胬肉切除联合自体角膜缘干细胞移植手术的临床观察
李慧萍	宁夏回族自治区人民医院宁夏眼科医院	国际眼科杂志	宁夏地区沙眼患病率流行病学调查
李才锐	大理学院附属医院眼科大理学院临床医学研究中心	国际眼科杂志	青少年糖皮质激素性青光眼10例临床分析
李拓	中国湖北省恩施州中心医院眼科	国际眼科杂志	自体角膜缘干细胞移植联合MMC对翼状胬肉疗效的Meta分析
李招娜	济南市第二人民医院	临床眼科杂志	角膜干细胞移植在翼状胬肉显微手术中的应用
李敏	，中國新疆獨山子石化總廠醫院眼科	国际眼科杂志	自體角膜緣幹細胞球結膜移植治療翼狀胬肉
李敏	辽宁省鞍山市中心医院	中华眼视光学与视觉科学杂志	泪阜瘘管误诊1例
李敏	鞍山市中心医院眼科	中华实验眼科杂志	泪阜瘘管误诊一例
李敏	广西壮族自治区人民医院眼科	国际眼科杂志	眼科显微手术技能培训模式探讨
李新	山东省济南市中心医院眼科	中国实用眼科杂志	翼状胬肉切除联合羊膜移植术临床应用
李新	山东省济南市中心医院眼科	临床眼科杂志	两种方法保存羊膜联合自体角膜缘移植治疗复发性翼状胬肉
李新章	青海红十字医院	眼外伤职业眼病杂志	保存人羊膜移植治疗翼状胬肉临床观察
李昀熹	解放军273医院眼科	中国中医眼科杂志	浅层巩膜烧灼联合角膜缘干细胞移植治疗翼状胬肉
李昂	中国人民解放军第463医院眼科	国际眼科杂志	翼状胬肉扩大切除联合自体角膜缘干细胞移植术的临床疗效观察
李昂	湖南省人民医院眼科	中国中医眼科杂志	白内障术前清洁结膜囊方法的比较
李明新	徐州医学院附属医院眼科	国际眼科杂志	三种不同术式治疗复发性翼状胬肉的疗效观察
李明桂	广西北海市人民医院眼科	中华实验眼科杂志	角膜缘干细胞移植治疗翼状胬肉低复发率手术技巧
李明桂	中国广西壮族自治区北海市人民医院眼科	国际眼科杂志	头部撕除法联合羊膜移植治疗翼状胬肉疗效观察
李明桂	广西北海市人民医院眼科	中国眼耳鼻喉科杂志	前弹力层撕除联合角膜缘干细胞移植治疗翼状胬肉
李明渊	中南大学湘雅三医院眼科	中华实验眼科杂志	HIF-1与VEGF在翼状胬肉中的表达及意义
李明芝	云南省大理州人民医院眼科	眼外伤职业眼病杂志	眼外伤及眼表疾病自体角膜缘干细胞移植术
李明芝	大理州医院	眼外伤职业眼病杂志	羊膜移植联合丝裂霉素C防止翼状胬肉术后复发
李昕	深圳广东边防武警总队医院眼科	眼外伤职业眼病杂志	排多癌防治翼状胬肉术后复发疗效观察
李星星	解放军总医院眼科	中国实用眼科杂志	上睑外侧退行性内翻对高龄老年人的影响
李春丽	兰州大学第二医院眼科	中国实用眼科杂志	兰州地区细菌性结膜炎的致病菌分布和耐药性分析
李春武	中国上海第二军医大学附属长海医院	国际眼科杂志	胬肉切除联合球结膜瓣转位术的疗效
李晓林	甘肃省兰州市第一人民医院	中国眼耳鼻喉科杂志	自体角膜缘干细胞移植治疗眼表面疾病
李晓艳	解放军总医院304临床部眼科	国际眼科杂志	体外培养自体角膜缘干细胞移植术治疗翼状胬肉1例
李晓艳	解放军总医院第一附属医院眼科	国际眼科杂志	自体角膜缘干细胞移植与自体体外培养角膜干细胞移植治疗翼状胬肉临床观察
李晓艳	解放军总医院第304临床部眼科	中国实用眼科杂志	羊膜和角膜干细胞移植治疗眼表疾病临床观察
李晓静	青岛大学医学院附属医院眼科	中国实用眼科杂志	人工泪液与重组人表皮生长因子衍生物眼液对翼状胬肉术后干眼疗效观察
李景平	河北省职工医学院附属医院眼科	眼科	部分切除并联合自体角膜上皮干细胞移植治疗翼状胬肉
李月芝	河北省沧州市运河区眼科医院	眼外伤职业眼病杂志	翼状胬肉术中应用丝裂霉素C的临床观察
李月芝	河北省沧州眼科医院	临床眼科杂志	老年性下睑外翻手术治疗的探讨
李杰	广西医科大学第一附属医院眼科	眼外伤职业眼病杂志	氟米龙滴眼液致翼状胬肉切除术后巩膜溃疡一例
李松峰	河南新乡医学院三附院眼科	中国斜视与小儿眼科杂志	双眼球后退综合征伴"鳄鱼泪"一例
李林	遵义医学院第五附属珠海医院眼科	眼外伤职业眼病杂志	两种翼状胬肉结膜移植手术美容效果观察
李柏军	中国广东省深圳市宝安区人民医院眼科	国际眼科杂志	Survivin蛋白和Fas蛋白在原发性翼状胬肉中的表达及其相关性研究
李楠	大连医科大学附属第一医院急诊科	国际眼科杂志	球结膜瓣转移结合丝裂霉素C治疗翼状胬肉
李正时	四川省自贡市第一人民医院	眼科	自体角膜缘干细胞联合羊膜移植治疗复发性翼状胬肉
李正贤	解放军第一六三医院眼科	中国实用眼科杂志	FⅧ-RAg VEGF在翼状胬肉中表达和微血管密度检测及其意义
李正贤	解放军第一六三医院眼科	中华眼科杂志	翼状胬肉中诱导一氧化氮合酶与FⅧ相关抗原表达的研究
李毅宏	广西桂林市人民医院眼科	中国眼耳鼻喉科杂志	重组人表皮生长因子滴眼液对翼状胬肉术后角膜上皮愈合的影响
李毓敏	浙江大学医学院附属第一医院	中国实用眼科杂志	富马酸酮替芬滴眼液治疗季节变应性结膜炎眼痒及结膜充血的疗效观察
李水卿	山东省荣成市人民医院眼科	临床眼科杂志	荣成市渔民翼状胬肉的流行病学调查
李永华	中山大学中山眼科中心	中国实用眼科杂志	医源性散瞳诱发青光眼急性发作的临床分析
李永平	中山大学中山眼科中心	中华眼科杂志	翼状胬肉上皮细胞p53蛋白的表达及其功能状态的研究
李永平	中山大学中山眼科中心中山大学眼科学国家重点实验室	中华眼科杂志	翼状胬肉组织中血管拟态的初步研究
李永平	中山大学眼科学国家重点实验室	中华实验眼科杂志	CD34在翼状胬肉中表达的意义
李汉林	南昌大学第一附属医院眼科	眼外伤职业眼病杂志	翼状胬肉不同术式预防复发的对比研究
李汉钊	云南省大理州人民医院眼科	眼外伤职业眼病杂志	眼外伤及眼表疾病自体角膜缘干细胞移植术
李汉钊	云南省大理州医院眼科	眼外伤职业眼病杂志	羊膜移植术治疗翼状胬肉临床分析
李汉钊	云南省大理白族自治州人民医院眼科	临床眼科杂志	翼状胬肉与角膜散光的关系初步报告
李洪荣	商河县中医医院眼科	中国中医眼科杂志	左眼角巩膜长期存留异物1例
李洪龙	中国广东汕头市中心医院眼科	国际眼科杂志	羊膜移植联合丝裂霉素术中应用预防翼状胬肉复发的前瞻性研究
李海	中国江苏省昆山市第一人民医院	国际眼科杂志	VEGF、CD34、Ki-67和p21在翼状胬肉中的表达及意义
李海丽	北京大学第一医院眼科	中华眼科杂志	眼瘢痕性类天疱疮病例的回顾性分析
李海军	河北北方学院	中国实用眼科杂志	翼状胬肉切除术致迟发型眼-胃肠反射一例
李海波	江苏省南京市中医院眼科	眼科	滴用盐酸奥布卡因引起一过性瞳孔散大三例
李海波	厦门大学附属厦门眼科中心	国际眼科杂志	翼状胬肉组织Caveolin-1,E-cadherin和P63的表达
李海燕	中国协和医科大学	中华眼科杂志	瘢痕性类天疱疮眼部病变一例
李海燕	山西省眼科医院病理科	中国实用眼科杂志	翼状胬肉中Ki-67和VEGF的表达
李海辉	中国陕西省延安市人民医院眼科	国际眼科杂志	复发性翼状胬肉逆行切除包埋加自体角膜缘干细胞移植术疗效观察
李淑珍	商丘市第一人民医院眼科	眼外伤职业眼病杂志	翼状胬肉术中应用丝裂霉素与羊膜移植的效果比较
李淑琳	广西中医学院附属瑞康医院眼科	中华实验眼科杂志	翼状胬肉发病机制的研究进展
李淑艳	江苏省淮安市第一人民医院眼科	临床眼科杂志	自体上方球结膜瓣转位治疗翼状胬肉疗效观察
李清花	福建省龙岩市第一医院眼科	中国眼耳鼻喉科杂志	慢性结膜炎患者中干眼症的患病率
李游	辽宁医学院附属第一医院眼科	国际眼科杂志	玻璃酸钠滴眼液对翼状胬肉转位术后泪膜恢复的作用
李湧	河南省平顶山市第一人民医院眼科	临床眼科杂志	慢性睑缘炎的临床特点及误诊分析
李满枝	中山大学肿瘤防治中心	中华眼科杂志	翼状胬肉上皮细胞p53蛋白的表达及其功能状态的研究
李灵	中国湖南省长沙市第四医院眼科	国际眼科杂志	两种不同翼状胬肉手术方式对角膜屈光的影响
李炜	厦门大学附属眼科中心厦门大学眼科研究所	中华眼科杂志	翼状胬肉上皮鳞状化生与泪膜稳定性的研究
李然	北京市眼科学与视觉科学重点实验室	中华实验眼科杂志	沙眼患者病原体基因型的鉴定分析
李然	烟台市牟平区中医院眼科	中国中医眼科杂志	双眼翼状胬肉切除联合角膜缘干细胞移植术的临床应用
李然	首都医科大学附属北京同仁医院眼科中心	眼科	沙眼患者临床与实验室诊断研究
李爱华	云南省大理州医院眼科	眼外伤职业眼病杂志	羊膜移植术治疗翼状胬肉临床分析
李爱华	山东省泰安市第一人民医院眼科	眼外伤职业眼病杂志	翼状胬肉切除结膜瓣反转式巩膜裸露术疗效观察
李爽	广东省汕尾逸挥基金医院眼科	中国实用眼科杂志	翼状胬肉不同手术方法疗效分析
李爽乐	四川省自贡市第一人民医院	眼科	自体角膜缘干细胞联合羊膜移植治疗复发性翼状胬肉
李玉	广西百色地区人民医院	眼外伤职业眼病杂志	自身角膜缘结膜移植治疗翼状胬肉
李玉丽	河南省直第三人民医院眼科	国际眼科杂志	旋转结膜瓣治疗翼状胬肉的远期疗效
李玉华	山东省临邑县人民医院眼科中心	眼外伤职业眼病杂志	角膜缘干细胞移植治疗复发性翼状胬肉
李玉翠	南京军区第180医院眼科	中国斜视与小儿眼科杂志	皮质激素性青光眼12例
李琳	河南省淮阳县人民医院眼科	中国眼耳鼻喉科杂志	联合丝裂霉素C和干细胞移植治疗复发性翼状胬肉
李琳玲	郧阳医学院附属太和医院眼科	国际眼科杂志	增殖细胞核抗原和胰岛素样生长因子Ⅱ在翼状胬肉组织中的表达
李琴	中国湖北省襄樊市中心医院眼科	国际眼科杂志	高频电灼浚通术治疗泪道阻塞的疗效观察
李琼	淮南新华医院集团新华医院眼科	临床眼科杂志	淮南市煤矿工人翼状胬肉患病率的流行病学调查
李瑾	温州医学院附属眼视光医院	中国实用眼科杂志	应用活体共焦显微镜观察翼状胬肉组织结构
李璐	武汉大学人民医院眼科中心	中华实验眼科杂志	趋化因子受体3及其配体在眼部疾病中的作用
李甦雁	中国江苏省徐州市第一人民医院眼科徐州市眼病防治研究所	国际眼科杂志	两种结膜植片缝合法对翼状胬肉手术的影响
李秀芹	济宁医学院附属金乡医院	眼外伤职业眼病杂志	自体角膜缘干细胞移植治疗翼状胬肉
李秋果	中国河南省扶沟县人民医院眼科	国际眼科杂志	自体角膜缘干细胞联合羊膜移植治疗眼表疾病
李程	首都医科大学附属北京儿童医院眼科	中国斜视与小儿眼科杂志	Ritleng 泪道插管术治疗结膜炎导致的儿童继发性泪道阻塞疗效观察
李程	厦门大学附属眼科中心厦门大学眼科研究所	中华眼科杂志	翼状胬肉上皮鳞状化生与泪膜稳定性的研究
李穗玲	秦皇岛市第一医院	眼外伤职业眼病杂志	自体结膜角膜缘上皮移植治疗翼状胬肉临床观察
李立平	河北职工医学院病理生理教研室	中华实验眼科杂志	术中应用丝裂霉素C治疗翼状胬肉实验和临床研究
李立新	河南省太康县人民医院眼科	眼外伤职业眼病杂志	自体角膜缘干细胞移植治疗翼状胬肉
李竑	山东省滨州市中心医院眼科	中国实用眼科杂志	翼状胬肉切除角膜缘重建术后无菌性巩膜融解
李竑	山东省滨州市中心医院眼科	中国实用眼科杂志	复发性翼状胬肉切除角膜缘重建术后泪膜功能变化
李竣	中國吉林省四平市中心醫院眼科	国际眼科杂志	自體眼表移植術治瘵翼狀胬肉
李筱荣	天津医科大学眼科中心	国际眼科杂志	云南省怒江州贡山县翼状胬肉的流行病学调查
李素芳	湖南省郴州市第三人民医院	中华眼视光学与视觉科学杂志	新鲜羊膜移植治疗翼状胬肉
李纳	首都医科大学附属同仁眼科中心	眼科	翼状胬肉大小与角膜地形图的相关性研究
李线	暨南大学医学院附属第二医院	中国实用眼科杂志	羊膜移植与自体角膜缘移植治疗翼状胬肉的初步疗效对照
李线	暨南大学医学院附属二医院眼科	眼外伤职业眼病杂志	羊膜联合自体角膜缘移植治疗复发性翼状胬肉
李线	深圳市人民医院暨南大学医学院第二附属医院眼科	眼外伤职业眼病杂志	角膜缘移植联合羊膜移植治疗角膜缘缺陷症
李线	暨南大学医学院附属第二医院	眼外伤职业眼病杂志	羊膜移植结膜囊再造治疗睑球粘连的临床观察
李线	深圳市人民医院暨南大学医学院二附院	眼科	新鲜羊膜移植治疗眼化学伤和翼状胬肉
李线	暨南大学医学院附属第二医院	中国实用眼科杂志	新鲜羊膜移植治疗翼状胬肉的临床观察
李绍伟	山东省眼科研究所	眼科	血管膜切除联合羊膜移植治疗复发性免疫性角结膜炎
李绍伟	青岛眼科医院	中国实用眼科杂志	羊膜移植与自体角膜缘移植治疗翼状胬肉的初步疗效对照
李绍军	中国北京市通州区妇幼保健院眼科	国际眼科杂志	带蒂结膜瓣移植联合丝裂霉素治疗翼状胬肉的疗效分析
李绍军	中国北京市通州区妇幼保健院眼科	国际眼科杂志	角膜干细胞移植治疗翼状胬肉的疗效分析
李维义	中国人民解放军第四二一医院眼科	国际眼科杂志	生物羊膜移植联合丝裂霉素和血管抑素治疗复发性翼状胬肉
李维义	中国人民解放军第四二一医院眼科	国际眼科杂志	术中应用丝裂霉素治疗不同类型原发性翼状胬肉的疗效观察
李维义	中国人民解放军第421医院眼科	国际眼科杂志	头孢曲松钠治疗新生儿淋球菌性结膜炎
李维娜	上海市同济大学附属东方医院	中国眼耳鼻喉科杂志	翼状胬肉剪除术和传统切除术的临床比较
李美军	驻香港部队医院眼科	国际眼科杂志	驻港部队海军和陆军战士眼部情况的对比分析
李羚	北京市中关村医院眼科	眼科	90Srβ射线照射预防翼状胬肉术后复发追踪观察
李群	深圳市眼科医院	临床眼科杂志	干眼对白内障手术的影响及其治疗方法
李翔骥	第三军医大学大坪医院野战外科研究所眼科专科医院	中华眼科杂志	睑结膜缝线致球结膜异物肉芽肿一例
李耀峰	河北医科大学附属哈励逊国际和平医院眼科	临床眼科杂志	泪小管炎2例
李良毛	解放军第一八一医院眼科中心	中华实验眼科杂志	治疗性准分子激光角膜切削术及其进展
李良毛	解放军181医院眼科中心	眼外伤职业眼病杂志	光学治疗性角膜切削术治疗复发性翼状胬肉
李艳	绵阳市富临医院	眼外伤职业眼病杂志	无缝隙缝合带角膜缘干细胞结膜瓣术治疗翼状胬肉
李艳	兰州大学第二医院眼科	中国实用眼科杂志	兰州地区细菌性结膜炎的致病菌分布和耐药性分析
李艳春	钦州市第二人民医院	眼外伤职业眼病杂志	羊膜移植治疗难治性眼表疾病的临床效果
李艳蓉	河南省兰考县中医院眼科	眼外伤职业眼病杂志	冷冻治疗早期翼状胬肉的临床观察
李芙蓉	第三军医大学新桥医院眼科	中国眼耳鼻喉科杂志	翼状胬肉术后巩膜溶解的临床观察
李若溪	中国辽宁省沈阳市第四人民医院眼科门诊	国际眼科杂志	眼内手术后病毒性角膜炎临床分析
李英明	辽宁抚顺眼病医院	中国实用眼科杂志	冻干人羊膜治疗翼状胬肉的临床观察
李茅	四川大学华西医院眼科中心	国际眼科杂志	翼状胬肉切除、大范围Tenon囊切除联合丝裂霉素C治疗翼状胬肉的临床研究
李荣花	中国河北省邯郸市眼科医院	国际眼科杂志	翼状胬肉发病机制及治疗研究进展
李莉	香港中文大学联合汕头国际眼科中心	中国中医眼科杂志	中药低温凉雾超声雾化法治疗春季结膜炎疗效观察
李莉	核工业四一六医院眼科	国际眼科杂志	翼状胬肉术后90Srβ射线敷贴治疗疗效观察及复发相关因素分析
李莉	广西壮族自治区人民医院眼科	中华实验眼科杂志	上泪道脓肿漏诊一例
李莉	河南省平顶山市第一人民医院眼科	临床眼科杂志	慢性睑缘炎的临床特点及误诊分析
李莉	广西壮族自治区人民医院眼科	国际眼科杂志	眼科显微手术技能培训模式探讨
李莉	黔东南州人民医院	眼外伤职业眼病杂志	羊膜移植重建眼表在基层医院的应用
李莉芬	中国广东省梅县人民医院眼科	国际眼科杂志	羊膜移植联合保留球结膜翼状胬肉切除术的临床研究
李莹	北京协和医院眼科	国际眼科杂志	左氧氟沙星滴眼液治疗重症细菌性角膜炎和结膜炎的临床观察
李莹	中国医学科学院北京协和医院眼科	眼科	过敏性结膜炎的流行病学及奥洛他定滴眼液开放性多中心治疗的初步效果
李莹	中国医学科学院北京协和医院	中华实验眼科杂志	重视变态反应性结膜炎治疗中非甾体抗炎药物的应用
李莹	中国医学科学院北京协和医院眼科	国际眼科杂志	过敏性眼表疾病临床现状分析
李菲	武汉大学人民医院眼科	中华实验眼科杂志	翼状胬肉切除联合自体球结膜移植术中使用纤维蛋白胶和缝线有效性的随机对照试验的Meta分析
李菲	广西南宁铁路医院	眼外伤职业眼病杂志	眼科手术后角膜缘溃疡临床分析(附3例报告)
李萌昌	复旦大学附属金山医院眼科	中国眼耳鼻喉科杂志	眼眶孤立性纤维瘤1例
李蓉	中国人民解放军第四军医大学西京医院眼科	国际眼科杂志	复发性翼状胬肉逆行切除包埋加自体角膜缘干细胞移植术疗效观察
李虹霓	中国广东汕头市中心医院眼科	国际眼科杂志	羊膜移植联合丝裂霉素术中应用预防翼状胬肉复发的前瞻性研究
李裕钦	陕西省人民医院眼科	国际眼科杂志	平阳霉素在翼状胬肉早期干预治疗中的应用
李裕钦	陕西省人民医院眼科	国际眼科杂志	三种手术方式治疗翼状胬肉疗效比较
李裕钦	陕西省人民医院眼科	眼外伤职业眼病杂志	翼状胬肉与角膜曲率
李贵刚	华中科技大学同济医学院附属同济医院眼科	国际眼科杂志	眼科门诊儿童患者干眼流行病学特征分析
李贵刚	华中科技大学同济医学院附属同济医院眼科	中华眼科杂志	糖皮质激素性高眼压患者外周血单个核细胞糖皮质激素受体α和β的表达
李赵霞	中国上海市浦东新区人民医院眼科	国际眼科杂志	自体角膜缘干细胞移植和自体游离球结膜移植治疗翼状胬肉的疗效观察
李超	河南新乡医学院三附院眼科	中国斜视与小儿眼科杂志	双眼球后退综合征伴"鳄鱼泪"一例
李超英	山东省烟台市烟台山医院眼科	中国实用眼科杂志	角膜缘干细胞移植治疗翼状胬肉
李超鹏	中国江苏省徐州市第一人民医院眼科徐州市眼病防治研究所	国际眼科杂志	两种结膜植片缝合法对翼状胬肉手术的影响
李越虹	中国中医科学院西苑医院眼科	中国中医眼科杂志	干眼误诊的临床因素分析
李轶捷	上海中医药大学附属普陀医院眼科	国际眼科杂志	结膜松弛症球结膜成纤维细胞培养的研究
李轶捷	上海中医药大学附属普陀医院	中华眼科杂志	结膜松弛症球结膜组织中热休克蛋白的表达
李辽青	首都医科大学北京同仁眼科中心	中华眼科杂志	结膜鳞状细胞癌侵犯眼球内一例
李达	中国陕西省榆林市星元医院眼科	国际眼科杂志	干眼症误诊的临床分析
李连洲	云梦县人民医院眼科	眼外伤职业眼病杂志	生物羊膜在复发性翼状胬肉术中应用评价
李逢	荷泽地区中医院眼科	中国中医眼科杂志	养血祛风汤治疗成年女性患者慢性结膜炎临床观察
李金涛	开滦医疗集团赵各庄医院眼科	国际眼科杂志	自体带蒂角膜缘干细胞移植术治疗翼状胬肉
李金花	广西壮族自治区民族医院眼科	国际眼科杂志	自体血清结膜下注射治疗过敏性结膜炎的临床研究
李金颖	牡丹江医学院附属医院眼病中心	国际眼科杂志	颈动脉海绵窦瘘误诊结膜炎1例
李钦兹	河南省漯河市第三人民医院	眼外伤职业眼病杂志	自体角膜缘移植治疗复发性翼状胬肉
李铮	郑州人民医院眼科	眼外伤职业眼病杂志	液氮冷冻治疗早期复发性翼状胬肉临床观察
李铮	郑州人民医院卓美眼科	眼外伤职业眼病杂志	翼状胬肉术后巩膜并发症的临床分析及治疗观察
李长优	省部共建国家重点实验室培育基地	中华实验眼科杂志	免疫刺激剂CpG ODN防治烟曲霉菌引起的变态反应性结膜炎的实验研究
李长瑞	武城县中医院	眼外伤职业眼病杂志	复发性翼状胬肉的综合治疗及临床观察
李际太	资兴市市立医院	眼外伤职业眼病杂志	翼状胬肉的三种手术方法疗效比较
李隐草	固始县中医院	眼外伤职业眼病杂志	三联术治疗翼状胬肉效果观察
李雪	沈阳爱尔眼视光医院	中国实用眼科杂志	外眦角泪腺排泄管异物二例
李雪	沈阳爱尔眼视光医院	中国实用眼科杂志	泪腺导管囊肿一例
李雯	福建省三明市第一医院遗传研究室	中华实验眼科杂志	睑结膜部炎症者肺炎衣原体、沙眼衣原体核酸检测
李霞	广西医科大学第一附属医院眼科	眼外伤职业眼病杂志	氟米龙滴眼液致翼状胬肉切除术后巩膜溃疡一例
李霞	上海交通大学附属瑞金医院皮肤科	中华实验眼科杂志	异位性皮炎的眼部并发症
李霞萍	复旦大学附属眼耳鼻喉科医院	中华眼科杂志	眼部自然杀伤-T细胞淋巴瘤致角膜穿孔一例
李青松	上海中医药大学附属普陀医院	中华眼科杂志	结膜松弛症球结膜组织中热休克蛋白的表达
李青松	上海中医药大学附属普陀医院眼科	国际眼科杂志	利用OCT观察流行性出血性结膜炎的临床研究
李青松	上海中医药大学附属普陀医院眼科	国际眼科杂志	结膜松弛症球结膜成纤维细胞培养的研究
李青松	上海中医药大学附属普陀医院眼科	中华眼科杂志	睑板腺功能异常
李静	邢台市第三医院	眼外伤职业眼病杂志	结膜吸吮线虫病一例
李静	陕西省人民医院眼科	中国实用眼科杂志	下泪小点息肉致长期泪溢二例
李颖	西安交通大学第一附属医院眼科	国际眼科杂志	翼状胬肉术前泪膜稳定性与术后复发相关性临床观察
李颖	天津医科大学眼科中心	国际眼科杂志	云南省怒江州贡山县翼状胬肉的流行病学调查
李颖	中国山东省邹城市人民医院眼科	国际眼科杂志	大范围切除联合新鲜羊膜移植治疗复发性翼状胬肉
李颖	西安市中心医院眼科	临床眼科杂志	角膜缘干细胞移植加丝裂霉素C棉片浸放与新鲜羊膜移植治疗翼状胬肉的对比观察
李骏	北京大学第一医院眼科	中华眼科杂志	抗过敏滴眼液对体外培养的人角膜上皮细胞的毒性作用
李鹏	解放军181医院眼科中心	眼外伤职业眼病杂志	光学治疗性角膜切削术治疗复发性翼状胬肉
李鹏程	华中科技大学同济医学院附属协和医院	中华眼视光学与视觉科学杂志	基质细胞衍生因子及其受体CXCR4在翼状胬肉的异常表达
李龙标	苏州大学附属第一医院眼科	中国实用眼科杂志	MMP-3、MMP-8在翼状胬肉中的表达
李龙标	苏州大学附属一院眼科	国际眼科杂志	MMP-8在翼状胬肉中的表达
李龙标	苏州大学附属第一医院眼科	眼外伤职业眼病杂志	自体角膜缘移植羊膜移植治疗翼状胬肉
杜仪琴	北京大学医学部干细胞研究中心	眼外伤职业眼病杂志	胚胎角膜干细胞移植治疗翼状胬肉的远期临床观察
杜冬梅	，中國山東省諸城市中醫院眼科	国际眼科杂志	結膜下注射平陽霉素致眼球内陷2例報道
杜冰	深圳市眼科医院	临床眼科杂志	干眼对白内障手术的影响及其治疗方法
杜冰	暨南大学医学院深圳眼科中心深圳市眼科医院	眼外伤职业眼病杂志	白内障合并翼状胬肉两种手术方案的选择
杜刚	中国人民解放军第161中心医院眼科	国际眼科杂志	角膜缘干细胞移植术治疗复发性翼状胬肉的疗效
杜娟	焦作市第二人民医院眼科	眼外伤职业眼病杂志	原发性翼状胬肉术后90Sr敷贴治疗临床观察
杜媛媛	兰州大学第二医院眼科	国际眼科杂志	甘肃舟曲县藏汉族小学生干眼症的流行病学调查
杜宁静	广西壮族自治区人民医院眼科	眼外伤职业眼病杂志	色甘酸钠减少胬肉术中丝裂霉素影响的观察
杜宁静	广西壮族自治区人民医院眼科	眼外伤职业眼病杂志	丝裂霉素C联合结膜徙盖术治疗复发性翼状胬肉
杜志山	天津宝坻县医院眼科	眼外伤职业眼病杂志	羊膜移植治疗复发性翼状胬肉
杜惠娟	广西中医药大学附属瑞康医院眼科	临床眼科杂志	准分子激光治疗早期复发性翼状胬肉的临床观察
杜成玲	珠海市香洲区人民医院眼科	眼外伤职业眼病杂志	新鲜羊膜联合自体角膜缘移植治疗复发性翼状胬肉
杜振亚	海口市人民医院眼科	中华眼科杂志	自体角膜缘上皮移植术治疗翼状胬肉的临床分析
杜新华	上海交通大学附属上海市第六人民医院眼科	临床眼科杂志	单纯结膜转位术与联合视原胶原植入术治疗翼状胬肉的疗效观察
杜新华	上海交通大学附属上海市第六人民医院眼科	中华实验眼科杂志	翼状胬肉切除联合结膜转位及视原植入术治疗翼状胬肉的疗效观察
杜新华	上海交通大学附属第六人民医院眼科	临床眼科杂志	脉络膜黑色素瘤误诊为视网膜脱离1例
杜新华	浙江省平湖市眼科医院	眼外伤职业眼病杂志	角膜缘干细胞移植治疗翼状胬肉
杜旭果	邯郸市眼科医院	眼外伤职业眼病杂志	泪道冲洗碘必殊眼膏注入联合按压治疗泪小管炎
杜晓华	玉溪市第一人民医院眼科	中国中医眼科杂志	新生儿淋菌性结膜炎的疗效观察
杜欣	广东省人民医院血液科	中华眼科杂志	移植物抗宿主病相关的干眼病
杜欣	广东省人民医院血液科	中华实验眼科杂志	造血干细胞移植术后的眼部观察
杜玉敏	海军青岛401医院眼科	眼外伤职业眼病杂志	不同部位角膜干细胞移植治疗翼状胬肉的疗效分析
杜立群	山东大学齐鲁医院眼科	中国实用眼科杂志	坏死性巩膜炎1例
杜素强	中国河南省扶沟县人民医院眼科	国际眼科杂志	自体角膜缘干细胞联合羊膜移植治疗眼表疾病
杜红	盐港医院眼科	眼外伤职业眼病杂志	初发胬肉与复发胬肉中ⅠL-1α和VEGFR-1的表达相关性研究
杜红	中国沈阳铁路中心医院眼科	国际眼科杂志	丝裂霉素C在翼状胬肉转移术中的应用
杜红	深圳市梅沙医院	中国实用眼科杂志	IL-1 α在初发与复发性翼状胬肉中的异常表达
杜红艳	内蒙古医学院	眼科	自体角膜缘干细胞移植联合应用平阳霉素治疗翼状胬肉
杜蜀华	同济医科大学附属同济医院	眼科	干扰素α-2b对结膜下成纤维细胞生长形态的影响
杜诚	浙江省嘉兴市中医院眼科	中国眼耳鼻喉科杂志	泪小管切开治疗泪小管炎伴结石13例
杜霞玉	黄浦区中心医院眼科	中国实用眼科杂志	自体角膜缘上皮移植治疗复发性翼状胬肉
杜颖红	浙江省舟山市普陀人民医院眼科	中国中医眼科杂志	翼状胬肉切除术后辅用中药的疗效观察
杜鹃	黑龙江省佳木斯市中心医院眼科	中国眼耳鼻喉科杂志	环氧化酶2在翼状胬肉中的表达及意义
杨万举	武汉大学人民医院眼科	临床眼科杂志	春季卡他性结膜炎的药物治疗疗效观察
杨世民	兰考县中医院眼科	眼外伤职业眼病杂志	宽大翼状胬肉双有蒂结膜移植手术的设计与应用
杨世民	河南省兰考县中医院眼科	眼外伤职业眼病杂志	冷冻治疗早期翼状胬肉的临床观察
杨东	武汉市第六医院眼科	中国眼耳鼻喉科杂志	翼状胬肉切除术联合丝裂霉素与角膜缘上皮移植的疗效观察
杨丹	中国四川省宜宾市第二人民医院眼科	国际眼科杂志	单眼双侧翼状胬肉联合手术临床疗效观察
杨丽	郑州市第二人民医院眼科	临床眼科杂志	保存人羊膜和自体角膜缘移植术治疗复发性翼状胬肉临床观察
杨义	兰州大学第二医院眼科	中国实用眼科杂志	兰州地区细菌性结膜炎的致病菌分布和耐药性分析
杨乐欣	兰州大学第二医院眼科	国际眼科杂志	甘肃舟曲县藏汉族小学生干眼症的流行病学调查
杨于力	第三军医大学西南医院	中国实用眼科杂志	原发性结膜肿瘤728例临床病理分析
杨于力	第三军医大学西南医院眼科	眼外伤职业眼病杂志	翼状胬肉两种不同术式临床疗效对比
杨云东	中国河北省沧州市	国际眼科杂志	河北省沧州城区6~14岁学龄儿童眼病现况调查
杨云波	武警湖北总队医院眼科	眼科	基质金属蛋白酶、凋亡、端粒酶与翼状胬肉
杨云波	武警湖北总队医院眼科	中国实用眼科杂志	新鲜羊膜移植治疗翼状胬肉48例临床观察
杨云良	江苏大学医学院附属医院	眼外伤职业眼病杂志	单纯性翼状胬肉两种手术方法的疗效比较
杨付合	山西运城市眼科医院	中国中医眼科杂志	干燥法保存角膜材料在板层角膜移植术中的疗效观察
杨伟光	山东潍坊医学院第三附属医院眼科	中国实用眼科杂志	自体角膜缘干细胞移植治疗翼状胬肉的疗效分析
杨伟永	山东省烟台经济技术开发区医院	临床眼科杂志	刮除上皮联合接触镜治疗点状角膜炎1例
杨克敏	廊坊市妇幼保健中心	眼外伤职业眼病杂志	泪小管异物误诊一例分析
杨兴旺	陕西省宝鸡市解放军第三医院眼科	中华眼视光学与视觉科学杂志	眼毛囊异位症合并睑板腺囊肿1例
杨兴林	南京市玄武医院眼科	临床眼科杂志	自体结膜角膜缘移植与自体结膜移植治疗复发性翼状胬肉
杨军	江西省宜春市人民医院眼科	中国眼耳鼻喉科杂志	结膜角膜缘上皮移植治疗翼状胬肉
杨冠	上海交通大学附属第六人民医院眼科	中华实验眼科杂志	翼状胬肉胶原变化的研究
杨冠	上海市第六人民医院眼科	临床眼科杂志	自体角膜缘干细胞移植联合羊膜移植治疗复发性翼状胬肉
杨冠	上海市吴泾医院眼科	眼外伤职业眼病杂志	生物羊膜或结膜移植治疗翼状胬肉的效果比较
杨冠	上海市第六人民医院	眼外伤职业眼病杂志	羊膜移植或联合自体角膜缘移植治疗翼状胬肉
杨冠	上海市第六人民医院	眼外伤职业眼病杂志	翼状胬肉侵入角膜程度对屈光状态的影响
杨冬妮	秦皇岛市第一医院	眼外伤职业眼病杂志	自体结膜角膜缘上皮移植治疗翼状胬肉临床观察
杨利芳	汉江职工医院眼科	国际眼科杂志	自体角膜缘干细胞移植治疗翼状胬肉疗效分析
杨劲松	湖南省人民医院眼科	中国中医眼科杂志	白内障术前清洁结膜囊方法的比较
杨勤	南京医科大学第一附属医院眼科	中国眼耳鼻喉科杂志	原发性翼状胬肉760例术后复发情况分析
杨勤	南京医科大学第一附属医院眼科	临床眼科杂志	羊膜移植在眼表疾病中的应用观察
杨华	西安市中心医院眼科	临床眼科杂志	角膜缘干细胞移植加丝裂霉素C棉片浸放与新鲜羊膜移植治疗翼状胬肉的对比观察
杨华	西安市中心医院眼科	临床眼科杂志	角膜缘干细胞移植联合丝裂霉素C应用对抑制翼状胬肉复发的初步观察
杨卫华	浙江省湖州市第一人民医院眼科研究所	中华实验眼科杂志	翼状胬肉术后巩膜融解分析
杨向红	濮阳光明医院眼科	中华实验眼科杂志	早产儿眼病的特征分析
杨君	甘肃省人民医院	眼外伤职业眼病杂志	表皮生长因子在翼状胬肉术后的应用观察
杨国华	解放军第546医院五官科	国际眼科杂志	带角膜缘干细胞结膜瓣移植治疗复发性翼状胬肉
杨国华	中国新疆维吾尔自治区乌鲁木齐市	国际眼科杂志	春季卡他性结膜炎患者泪液β2微球蛋白的测定及意义
杨培增	中山大学中山眼科中心	中华实验眼科杂志	汉防己甲素对翼状胬肉成纤维细胞抑制作用的实验研究
杨媛	暨南大学附属深圳市眼科医院	国际眼科杂志	泪点炎的临床观察研究
杨安怀	武汉大学人民医院眼科	国际眼科杂志	聚四氟乙烯联合角膜缘干细胞移植治疗复发性翼状胬肉并睑球粘连
杨安怀	武汉大学人民医院眼科	国际眼科杂志	角膜缘血管网切断联合生物羊膜移植治疗角膜新生血管
杨宏伟	中国医科大学盛京医院眼科	国际眼科杂志	自体结膜瓣移植治疗翼状胬肉的临床观察
杨小波	神木县眼科医院	眼外伤职业眼病杂志	眼部碱烧伤相关因素分析
杨少华	武夷山市立医院眼科，福建武夷山	眼科	自体角膜缘移植术治疗翼状胬肉
杨展华	福建省漳州市芝山卫生院眼科	眼外伤职业眼病杂志	平阳霉素滴眼预防翼状胬肉术后复发的观察
杨峥嵘	中国云南省第一人民医院眼科	国际眼科杂志	广泛切除联合术后丝裂霉素C滴眼治疗翼状胬肉
杨建东	中国人民解放军第81医院眼科	国际眼科杂志	Stevens-Johnson综合征1例
杨得雄	广西富川县人民医院眼科	临床眼科杂志	翼状胬肉切除联合带角膜缘上皮的自体结膜瓣移植术152例疗效观察
杨志伟	神木县眼科医院	眼外伤职业眼病杂志	眼部碱烧伤相关因素分析
杨志强	漯河市中心医院	眼外伤职业眼病杂志	单纯羊膜移植和联合角膜缘移植治疗翼状胬肉
杨志强	河南省漯河市第三人民医院	眼外伤职业眼病杂志	自体角膜缘移植治疗复发性翼状胬肉
杨慧玲	湖南省儿童医院眼科	国际眼科杂志	婴幼儿泪囊炎的治疗综述
杨振华	湖北省五峰土家族自治县第二人民医院眼科	中国眼耳鼻喉科杂志	泪道探通联合药物冲洗治疗婴幼儿泪囊炎
杨文忠	浙江省德清县人民医院眼科	临床眼科杂志	冷冻干燥羊膜移植治疗睑球粘连的临床观察
杨文敏	湖北省十堰市东风汽车公司茅箭医院眼科	眼外伤职业眼病杂志	翼状胬肉术后复发的防治探讨
杨新怀	广东省中山市小榄人民医院眼科	眼外伤职业眼病杂志	新鲜及保存羊膜移植治疗翼状胬肉
杨新怀	中山市小榄人民医院眼科	中国中医眼科杂志	自体角膜缘干细胞移植联合丝裂霉素C治疗翼状胬肉的临床研究
杨新怀	中山市小榄人民医院眼科	中国中医眼科杂志	平阳霉素治疗早期复发性翼状胬肉疗效观察
杨明善	喀什农三师医院眼科	眼外伤职业眼病杂志	自体角膜缘干细胞移植治疗翼状胬肉148例
杨春玉	河南安阳钢铁集团公司职工总医院眼科	眼外伤职业眼病杂志	平阳霉素在翼状胬肉手术后的应用
杨晋	复旦大学附属眼耳鼻喉科医院	眼外伤职业眼病杂志	结膜乳头切除加丝裂霉素C治疗春季角结膜炎
杨晓慧	首都医科大学附属北京同仁医院跟科中心北京市眼科研究所	眼科	北京农村老年居民翼状胬肉患病情况分析
杨晓波	牡丹江医学院红旗医院一门诊眼科	眼外伤职业眼病杂志	羊膜移植治疗眼部烧伤并发症的疗效
杨晓然	南方医科大学附属南海医院眼科	国际眼科杂志	显微镜下斜视矫正术
杨晓英	攀枝花学院附属医院眼科	国际眼科杂志	翼状胬肉术后巩膜融解14例临床分析
杨智	绵阳市富临医院	眼外伤职业眼病杂志	无缝隙缝合带角膜缘干细胞结膜瓣术治疗翼状胬肉
杨朝举	大理州医院	眼外伤职业眼病杂志	羊膜移植联合丝裂霉素C防止翼状胬肉术后复发
杨松霖	北京大学第一医院眼科	中华眼科杂志	眼瘢痕性类天疱疮病例的回顾性分析
杨柳	牡丹江医学院红旗医院一门诊眼科	眼外伤职业眼病杂志	羊膜移植治疗眼部烧伤并发症的疗效
杨柳青	河南省直第三人民医院眼科	国际眼科杂志	旋转结膜瓣治疗翼状胬肉的远期疗效
杨树楦	新疆石河子大学医学院附属医院眼科	临床眼科杂志	85例眼红斑痤疮临床分析
杨桂芳	武汉大学中南医院病理科	国际眼科杂志	Bcl-2和MMP-9在翼状胬肉中的表达及意义
杨欣	温州医学院附属眼视光医院	中国实用眼科杂志	应用活体共焦显微镜观察翼状胬肉组织结构
杨永清	湖北省十堰市东风汽车公司茅箭医院眼科	眼外伤职业眼病杂志	翼状胬肉术后复发的防治探讨
杨永福	云南省玉溪市人民医院眼科	中华眼科杂志	结膜真菌病误诊一例
杨永福	玉溪市第一人民医院眼科	中国中医眼科杂志	新生儿淋菌性结膜炎的疗效观察
杨波	新疆维吾尔自治区人民医院眼科	眼科	先天性眼皮肤黑变病继发青光眼一例
杨波	象山县第一人民医院	眼外伤职业眼病杂志	羊膜联合自体角膜缘干细胞移植治疗复发性翼状胬肉
杨洁	海口，海南省人民医院眼科	中华眼科杂志	海南省两县(市)翼状胬肉患病率的调查
杨洁清	云南省玉溪市人民医院眼科	中华眼科杂志	结膜真菌病误诊一例
杨清秀	中国广东省深圳市宝安区人民医院眼科	国际眼科杂志	Survivin蛋白和Fas蛋白在原发性翼状胬肉中的表达及其相关性研究
杨潇远	郑州市第二人民医院	中国实用眼科杂志	丝状角膜炎的临床治疗观察
杨潇远	郑州市第二人民医院眼科	眼外伤职业眼病杂志	翼状胬肉不同手术方法的疗效比较
杨潮	中日友好医院眼科	中华眼科杂志	禽流感病毒结膜炎的流行及其眼嗜性的分子基础
杨燕	玉溪市第一人民医院眼科	中国中医眼科杂志	新生儿淋菌性结膜炎的疗效观察
杨燕宁	武汉大学人民医院眼科	国际眼科杂志	角膜缘血管网切断联合生物羊膜移植治疗角膜新生血管
杨燕宁	武汉大学人民医院眼科中心	国际眼科杂志	原发性进展型翼状胬肉与泪膜的相关性研究
杨燕宁	武汉大学人民医院眼科武汉大学医学院眼科研究所	中国实用眼科杂志	异体巩膜联合多层羊膜移植治疗翼状胬肉术后无菌性角巩膜融解的疗效探讨
杨燕宁	武汉大学人民医院眼科	临床眼科杂志	春季卡他性结膜炎的药物治疗疗效观察
杨玉勇	河北省张家口市第四医院眼科	中国实用眼科杂志	非炎性坏死性巩膜溃疡
杨玉君	中国甘肃省临洮县新添铺中心卫生院眼科	国际眼科杂志	平阳霉素注射治疗翼状胬肉的临床观察
杨玉新	新乡医学院第一附属医院眼科	国际眼科杂志	长期联合应用噻吗洛尔对结膜组织炎性反应的影响
杨玲	河北省秦皇岛市	眼外伤职业眼病杂志	翼状胬肉逆行切除合并丝裂霉素应用预防复发观察
杨玲玲	省部共建国家重点实验室培育基地	中华实验眼科杂志	免疫刺激剂CpG ODN防治烟曲霉菌引起的变态反应性结膜炎的实验研究
杨珊珊	青岛大学医学院附院	眼外伤职业眼病杂志	翼状胬肉术中应用丝裂霉素C预防复发的观察
杨珊珊	青岛大学医学院附属医院眼科	中华实验眼科杂志	1％阿奇霉素滴眼液治疗细菌性结膜炎的随机、双盲、临床对照试验
杨瑞	河南省新乡市第一人民医院眼科	眼外伤职业眼病杂志	翼状胬肉术联合药物应用的临床观察
杨瑞明	广州医学院第二附属医院眼科	中华实验眼科杂志	广东地区变应性结膜炎变应原筛选及预防
杨瑞明	广州医学院第二附属医院眼科	中国实用眼科杂志	螨脱敏治疗变应性结膜炎的观察
杨瑞波	天津医科大学眼科医院	国际眼科杂志	纤维蛋白胶在翼状胬肉切除联合自体角膜缘干细胞移植术中的临床效果
杨瑞波	天津医科大学眼科研究所	国际眼科杂志	表面麻醉下翼状胬肉手术中应用纤维蛋白胶的效果
杨相泽	山东省威海市立医院眼科	中国眼耳鼻喉科杂志	新生儿泪囊炎的按摩治疗法
杨磊	兰州军区兰州总医院眼科中心	中华眼科杂志	翼状胬肉切除联合结膜自体移植术中纤维蛋白胶应用的Meta分析
杨立东	河北省沧州眼科医院	中华眼科杂志	板层巩膜移植治愈真菌性巩膜炎一例
杨立东	中国河北省沧州市	国际眼科杂志	河北省沧州城区6~14岁学龄儿童眼病现况调查
杨立善	浙江省苍南县人民医院眼科	中国实用眼科杂志	儿童糖皮质激素性青光眼或高眼压23例临床分析
杨立新	山东淄博市第一医院眼科	眼科	翼状胬肉切除术后平阳霉素的使用
杨筱曦	暨南大学附属第一医院眼科	中华实验眼科杂志	丝裂霉素C对翼状胬肉成纤维细胞膜通透性及超微结构的影响
杨素碧	白求恩国际和平医院	中国中医眼科杂志	柳叶液抑制肠病毒70型的体外实验研究
杨红	中国青海省四宁市	国际眼科杂志	自体干细胞移植治疗翼状胬肉50例疗效观察
杨红云	山东省新泰市人民医院眼科	中国眼耳鼻喉科杂志	自体角膜缘组织移植治疗翼状胬肉
杨纪忠	中国山西省眼科医院角膜科	国际眼科杂志	巩膜暴露法联合术中应用丝裂霉素C治疗双头翼状胬肉
杨纪忠	山西省眼科医院	中国斜视与小儿眼科杂志	儿童泡性眼炎病因分析及治疗
杨继若	兰州市第一人民医院	中国中医眼科杂志	针灸治疗目劄
杨美东	湖北荆门市石化医院	眼外伤职业眼病杂志	5-氟尿嘧啶联合自体角膜缘组织移值治疗翼状胬肉
杨自更	兰州军区乌鲁木齐总医院眼科	中华实验眼科杂志	维汉民族中学生沙眼衣原体感染调查
杨萍	中国河南省固始县人民医院眼科	国际眼科杂志	巩膜桥加压掩盖法治疗复发性翼状胬肉22例
杨蕾	上海市宝山区宝山中心医院	眼外伤职业眼病杂志	羊膜移植与自体角膜缘干细胞移植治疗翼状胬肉的效果对比
杨蕾	中国上海市宝山区中心医院眼科	国际眼科杂志	激素诱发青光眼或高眼压的临床分析
杨薇	中国中医科学院眼科医院	中国中医眼科杂志	川椒方治疗过敏性结膜炎的临床观察
杨虹	青海省中医院眼科	临床眼科杂志	显微自体干细胞移植治疗50例翼状胬肉临床疗效观察
杨道华	中国上海市松江区中心医院眼科	国际眼科杂志	翼状胬肉基质金属蛋白酶表达的意义
杨金华	浙江绍兴第二医院眼科	眼外伤职业眼病杂志	贝复舒滴眼液对翼状胬肉术后角膜上皮作用的临床观察
杨金华	绍兴第二医院	眼外伤职业眼病杂志	翼状胬肉术前术后屈光变化的临床观察
杨铭	湖南省永州市人民医院	中国实用眼科杂志	保存羊膜与新鲜羊膜治疗眼表疾病的比较研究
杨锦荣	广东医学院病理学教研室	国际眼科杂志	翼状胬肉组织中Bcl-2和ICAM-1的表达
杨阳	中国陕西省榆林市星元医院眼科	国际眼科杂志	干眼症误诊的临床分析
杨雯	四川大学华西医院眼科	中华实验眼科杂志	双眼结膜淀粉样变性一例
杨霞	湖北航天医院眼科	国际眼科杂志	原发性翼状胬肉两种治疗方法的疗效观察
杨静	福建省三明市第一医院遗传研究室	中华实验眼科杂志	睑结膜部炎症者肺炎衣原体、沙眼衣原体核酸检测
杨顺玲	河北省邯郸市眼科医院	临床眼科杂志	超声乳化白内障摘除联合人工晶状体植入术后低视力原因分析
杨领娣	山东大学附属省立医院眼科中心	中华眼科杂志	山东省滕州市2676名农村小学生沙眼患病调查
杨飏	中国医科大学盛京医院眼科	国际眼科杂志	自体结膜瓣移植治疗翼状胬肉的临床观察
杭丽	江苏省中医院眼科	国际眼科杂志	鱼腥草滴眼液联合吡嘧司特钾滴眼液治疗过敏性结膜炎的疗效观察
林东	福建省闽候县人民医院眼科	眼外伤职业眼病杂志	双裸式结膜桥联合局部注射曲安缩松治疗翼状胬肉
林健贤	中山大学中山眼科中心	中国实用眼科杂志	翼状胬肉切除对泪液功能的影响
林健贤	中山大学中山眼科中心	中华眼科杂志	移植物抗宿主病相关的干眼病
林健贤	中山大学中山眼科中心	中华眼科杂志	翼状胬肉上皮细胞p53蛋白的表达及其功能状态的研究
林兰英	山东省高唐县人民医院眼科	眼外伤职业眼病杂志	角膜缘组织和球结膜伸展移植治疗翼状胬肉
林刚	黔东南州人民医院	眼外伤职业眼病杂志	羊膜移植重建眼表在基层医院的应用
林加祥	浙江省洞头县人民医院眼科	中国眼耳鼻喉科杂志	翼状胬肉切除后角膜缘结膜瓣移植术
林国乔	南京医科大学附属南京第一医院眼科	国际眼科杂志	翼状胬肉切除术前与术后角膜变化的研究
林孝诚	福建省福清市医院眼科	中华实验眼科杂志	肉毒杆菌毒素A治疗特发性眼睑痉挛疗效观察
林宝涛	深圳暨南大学附属深圳市眼科医院	中国斜视与小儿眼科杂志	新生儿淋菌性结膜炎致病菌10年药物敏感性的变迁
林宝涛	暨南大学附属深圳市眼科医院	中国实用眼科杂志	新生儿急性细菌性结膜炎10年致病菌变迁
林少春	中山大学中山眼科中心国家重点实验室	国际眼科杂志	汉防己甲素体外对正常结膜与翼状胬肉成纤维细胞抑制作用的比较
林少春	中山大学中山眼科中心	中国实用眼科杂志	正常球结膜与翼状胬肉成纤维细胞生长增殖状况的对比观察
林少春	中山大学中山眼科中心国家重点实验室	中国中医眼科杂志	初复发翼状胬肉相关因子检测及汉防己甲素作用观察
林少春	中山大学中山眼科中心中山大学眼科学国家重点实验室	国际眼科杂志	汉防己甲素对翼状胬肉成纤维细胞基质金属蛋白酶的影响
林少春	中山大学中山眼科中心	中华实验眼科杂志	汉防己甲素对翼状胬肉成纤维细胞抑制作用的实验研究
林少春	中山大学中山眼科中心中山大学眼科学国家重点实验室	国际眼科杂志	汉防己甲素抑制翼状胬肉成纤维细胞增殖的研究
林建贤	中山大学中山眼科中心	中华实验眼科杂志	造血干细胞移植术后的眼部观察
林春生	福建省莆田县黄石卫生院眼科	眼外伤职业眼病杂志	应用丝裂霉素C治疗原发性翼状胬肉临床研究
林林	滨州医学院流行病学教研室	中华实验眼科杂志	麦考酚酸抑制翼状胬肉成纤维细胞的作用机制
林海华	浙江省洞头县人民医院眼科	中国眼耳鼻喉科杂志	翼状胬肉切除后角膜缘结膜瓣移植术
林淑玲	福建省永安市三明第二医院眼科	中国实用眼科杂志	羊膜移植治疗翼状胬肉50例临床探讨
林燕青	福建省尤溪县医院	中国眼耳鼻喉科杂志	角膜缘干细胞移植治疗翼状胬肉45例报告
林玉清	福建省莆田县黄石卫生院眼科	眼外伤职业眼病杂志	应用丝裂霉素C治疗原发性翼状胬肉临床研究
林玲	福建医科大学附属二院免疫内科	中国实用眼科杂志	系统性红斑狼疮患者眼表损害及相关抗体检测
林琳	海南省人民医院眼科	眼科	奥洛他定联合FK506滴眼液治疗儿童严重春季角结膜炎的疗效观察
林盛金	深圳市布吉人民医院眼科	眼外伤职业眼病杂志	改良翼状胬肉手术研究报告
林秀琴	金川集团公司职工医院	眼外伤职业眼病杂志	羊膜移植联合丝裂霉素C在复发性翼状胬肉手术中的应用
林跃生	中山大学中山眼科中心	中国实用眼科杂志	翼状胬肉切除对泪液功能的影响
林跃生	中山大学中山眼科中心	中国实用眼科杂志	新生儿急性细菌性结膜炎细菌培养结果分析
林跃生	中山大学眼科中心	眼外伤职业眼病杂志	眼外伤及眼表疾病自体角膜缘干细胞移植术
林跃生	广州中山大学中山眼科中心	中国斜视与小儿眼科杂志	新生儿急性细菌性结膜炎病原菌及药物敏感性分析
林郁	中国广东省中山市人民医院眼科	国际眼科杂志	环孢霉素A在防止翼状胬肉复发中的作用
林锦希	广东省佛山市南海区大沥医院眼科	中国实用眼科杂志	复发性翼状胬肉角膜缘干细胞移植远期疗效观察
林雪松	中国福建省宁德市医院眼科	国际眼科杂志	羊膜移植与结膜移植治疗翼状胬肉的比较
林雪松	宁德市医院	眼外伤职业眼病杂志	羊膜移植在翼状胬肉术中的应用
林雯	福建省眼科研究所	眼科	自体角膜缘干细胞移植治疗翼状胬肉
林雯	福建医科大学第一附属医院	中华眼视光学与视觉科学杂志	基质金属蛋白酶-1及其抑制剂和转化生长因子-β1在翼状胬肉中的表达及意义
林雯	福建医科大学附属第一医院福建省眼科研究所	中国实用眼科杂志	翼状胬肉中细胞增殖与凋亡相关基因蛋白的表达及其意义
林静	青岛大学医学院附属医院眼科	国际眼科杂志	复发性翼状胬肉的治疗分析
林静君	中国广东汕头市中心医院眼科	国际眼科杂志	羊膜移植联合丝裂霉素术中应用预防翼状胬肉复发的前瞻性研究
林颖	福建中医学院附属人民医院眼科	中国中医眼科杂志	清开灵和干扰素对翼状胬肉成纤维细胞增殖的影响
林颖	福建省人民医院眼科	中华眼视光学与视觉科学杂志	细胞因子对翼状胬肉成纤维细胞增殖的影响
林颖	福建省人民医院眼科，福州	中国中医眼科杂志	眼痒安I号雾化治疗春季结膜炎疗效观察
柏文	山东省新泰市人民医院眼科	中国眼耳鼻喉科杂志	显微镜下游离结膜移植术治疗翼状胬肉
查敦传	安徽海螺集团公司总医院眼科宁国	中华实验眼科杂志	人羊膜联合自体角膜缘移植治疗复发性翼状胬肉
查敦玲	安徽海螺集团公司总医院眼科宁国	中华实验眼科杂志	人羊膜联合自体角膜缘移植治疗复发性翼状胬肉
柯峰	郧阳医学院附属十堰市人民医院眼科	国际眼科杂志	YAG泪道激光联合丝裂霉素及典必殊眼膏治疗泪道阻塞89例
柯敏	武汉大学中南医院眼科	中国实用眼科杂志	复发翼状胬肉显微切除联合羊膜及自体角膜缘移植临床分析
柯敏	武汉大学中南医院眼科	临床眼科杂志	结膜松弛症的临床及病理研究
柯梅青	上海中医药大学附属普陀医院眼科	国际眼科杂志	利用OCT观察流行性出血性结膜炎的临床研究
柯碧莲	上海市第一人民医院眼科	临床眼科杂志	羊膜移植联合眼表润滑剂及配镜治疗初发性翼性胬肉
柯碧莲	上海交通大学附属市第一人民医院眼科	中国眼耳鼻喉科杂志	羊膜移植在结膜重建中的应用
柳林	上海第二军医大学第一附属医院眼科	国际眼科杂志	人翼状胬肉组织HMG-CoA还原酶和LDL受体基因的表达
柳林	第二军医大学附属长海医院眼科	中华实验眼科杂志	翼状胬肉组织中CD_(34)、AC133、STRO 1、C KIT的表达
柳林	第二军医大学第一附属医院眼科	中华实验眼科杂志	翼状胬肉发病机制研究进展
柳林	中国上海第二军医大学附属长海医院眼利	国际眼科杂志	基质金属蛋白酶与角膜病变
柳林	第二军医大学附属长海医院眼科	临床眼科杂志	翼状胬肉切除联合羊膜或自体角膜缘干细胞移植术的临床应用研究
柳灿	广州市白云区红十字医院	中华实验眼科杂志	翼状胬肉术后角膜穿孔二例
柳灿	广州市白云区红十字会医院五官科	临床眼科杂志	翼状胬肉术后角膜穿孔2例
柴松	河北医科大学第二医院眼科	中国实用眼科杂志	肺癌多脏器转移首诊眼科1例
栗建华	山东省高唐县人民医院眼科	眼外伤职业眼病杂志	角膜缘组织和球结膜伸展移植治疗翼状胬肉
栾宏	济南市第四人民医院眼科	中国中医眼科杂志	角膜缘干细胞移植治疗复发性翼状胬肉的临床观察
桂習瑛	中國江西省吉安市中心人民醫院眼科	国际眼科杂志	人羊膜移植治療翼狀胬肉的臨床分析
桑爱民	南通大学附属医院	中国实用眼科杂志	翼状胬肉bFGF TNF-α p53表达的研究
梁丽琼	金川集团公司职工医院	眼外伤职业眼病杂志	羊膜移植联合丝裂霉素C在复发性翼状胬肉手术中的应用
梁俊文	南海市平洲镇医院	中华实验眼科杂志	5F对人翼状胬肉成纤维细胞增生及Fas表达的调控
梁俊芳	上海大华医院眼科	中国实用眼科杂志	532激光治疗早期翼状胬肉的临床观察
梁俊芳	中国上海市徐汇区大华医院眼科	国际眼科杂志	改良逆行撕剥术联合自体结膜瓣移植治疗翼状胬肉的临床观察
梁俊莲	新疆军区第23医院	中华实验眼科杂志	沙眼衣原体两种基因诊断方法的比较
梁先军	中国广东省佛山市第一人民医院眼科	国际眼科杂志	翼状胬肉角膜缘干细胞移植与羊膜移植的比较
梁凤康	广西百色地区人民医院	眼外伤职业眼病杂志	自身角膜缘结膜移植治疗翼状胬肉
梁利梅	中国陕西省安康市汉滨区第二医院眼科	国际眼科杂志	翼状胬肉切除术中应用丝裂霉素C联合自体角膜缘干细胞移植的疗效分析
梁勇	广西医科大学第一附属医院眼科中心	中国实用眼科杂志	翼状胬肉术后诊断为血友病A一例
梁厚成	中国陕西省西安市眼科医院	国际眼科杂志	翼状胬肉切除联合丝裂霉素C术后巩膜溶解的分析
梁君	山东省荣成市人民医院眼科	临床眼科杂志	荣成市渔民翼状胬肉的流行病学调查
梁四妥	中国河北省沧州市	国际眼科杂志	河北省沧州城区6~14岁学龄儿童眼病现况调查
梁委军	广西医科大学第四附属医院	眼外伤职业眼病杂志	新鲜羊膜移植治疗复发性翼状胬肉
梁娟	天津医科大学眼科中心	国际眼科杂志	云南省怒江州贡山县翼状胬肉的流行病学调查
梁婧	第三军医大学新桥医院眼科	中国眼耳鼻喉科杂志	翼状胬肉术后巩膜溶解的临床观察
梁庆丰	首都医科大学附属北京同仁医院跟科中心北京市眼科研究所	眼科	北京农村老年居民翼状胬肉患病情况分析
梁式森	广西医科大学第一附属医院眼科	眼外伤职业眼病杂志	翼状胬肉切除联合角膜缘组织移植术初步报告
梁惠文	广西北海市人民医院眼科	中国眼耳鼻喉科杂志	前弹力层撕除联合角膜缘干细胞移植治疗翼状胬肉
梁惠文	广西北海市人民医院眼科	中华实验眼科杂志	角膜缘干细胞移植治疗翼状胬肉低复发率手术技巧
梁慷	中国南京医科大学附属第一医院眼科	国际眼科杂志	盐酸洛美沙星眼凝胶临床生物等效性试验
梁敏	云南省巍山县人民医院眼科	眼外伤职业眼病杂志	干扰素联合结膜移植预防翼状胬肉术后复发
梁文旺	广西宜州市中医院眼科	眼外伤职业眼病杂志	翼状胬肉切除联合角膜缘组织移植术初步报告
梁日雄	广西南宁市第一人民医院	眼外伤职业眼病杂志	保存人羊膜在眼表疾病中的应用
梁曼	武警广东边防总队医院眼科医疗中心	中国眼耳鼻喉科杂志	角膜缘干细胞移植治疗翼状胬肉
梁松霞	中国陕西省商洛市中心医院眼科	国际眼科杂志	苏丹喀土穆地区春季卡他性角结膜炎720例临床分析
梁海	暨南大学附属深圳市眼科医院	国际眼科杂志	泪点炎的临床观察研究
梁玲	山东省德州市人民医院眼科	眼外伤职业眼病杂志	逆行切除联合巩膜裸露区烧灼治疗复发性翼状胬肉
梁祖忠	解放军第五医院眼科	眼外伤职业眼病杂志	贝复舒滴眼液在翼状胬肉术后的应用
梁莉	绵阳市富临医院	眼外伤职业眼病杂志	无缝隙缝合带角膜缘干细胞结膜瓣术治疗翼状胬肉
梁轩伟	广东省梅县人民医院五官科	中华眼科杂志	广东省梅县盲和低视力流行病学调查
梁轩伟	中国湛江广东医学院附属医院眼科	国际眼科杂志	羊膜移植联合保留球结膜翼状胬肉切除术的临床研究
梁静	天津市第四中心医院眼科	中国实用眼科杂志	自体角膜上皮移植治疗翼状胬肉
梁静文	中山大学中山眼科中心	国际眼科杂志	β-catenin在翼状胬肉成纤维细胞中的表达
梅军	驻香港部队医院	眼外伤职业眼病杂志	自体角膜缘干细胞移植治疗复发性翼状胬肉
梅军	福建省永安市三明第二医院眼科	中国实用眼科杂志	羊膜移植治疗翼状胬肉50例临床探讨
梅小飞	中国江苏省姜堰市人民医院眼科	国际眼科杂志	自体角膜缘干细胞移植联合MMC治疗翼状胬肉疗效观察
梅建忠	泰兴市人民医院	眼外伤职业眼病杂志	生物羊膜移植治疗复发性翼状胬肉临床观察
梅昌贵	遵义医学院第五附属珠海医院眼科	眼外伤职业眼病杂志	两种翼状胬肉结膜移植手术美容效果观察
梅淑萍	厦门市第一医院眼科	临床眼科杂志	肺癌眼部转移1例
梅鹤英	江西省宜丰县人民医院五官科	眼外伤职业眼病杂志	角膜异物剔除翼状胬肉切除手术致前房积血一例
楊曉	中國廣州中山醫科大學中山眼科中心	国际眼科杂志	羊膜移植治療翼狀胬肉
楚蒙	中国云南省红河州医院眼科	国际眼科杂志	自体带结膜瓣角膜缘干细胞移植治疗翼状胬肉
楼六一	浙江省绍兴市人民医院眼科	眼科	翼状胬肉切除术中丝裂霉素C的应用
楼六一	浙江省绍兴市人民医院眼科	中国实用眼科杂志	翼状胬肉切除术中与术后应用丝裂霉素C的比较
樊云葳	首都医科大学附属北京儿童医院眼科儿科学国家重点学科	中国斜视与小儿眼科杂志	儿童眼眶蜂窝织炎
樊云葳	首都医科大学附属北京儿童医院眼科	中国斜视与小儿眼科杂志	Ritleng 泪道插管术治疗结膜炎导致的儿童继发性泪道阻塞疗效观察
樊云葳	首都医科大学附属北京儿童医院眼科	中华实验眼科杂志	先天性阔睑一例
樊映川	四川省医学科学院四川省人民医院眼科	中国实用眼科杂志	近20年四川省主要视力残疾患病率变化分析
樊映川	四川省医学科学院四川省人民医院眼科	国际眼科杂志	四川省视力残疾状况分析
樊莹	上海市第一人民医院眼科	眼外伤职业眼病杂志	翼状胬肉切除联合丝裂霉素C应用致角膜自融穿孔一例
欧杰雄	中山大学中山眼科中心	中华眼底病杂志	系统性红斑狼疮并发视网膜静脉阻塞的临床分析
欧波	海口，海南省人民医院眼科	中华眼科杂志	海南省两县(市)翼状胬肉患病率的调查
欧良	高要市人民医院	眼外伤职业眼病杂志	自体角膜缘干细胞移植术治疗翼状胬肉
欧阳俊	绵阳市富临医院	眼外伤职业眼病杂志	无缝隙缝合带角膜缘干细胞结膜瓣术治疗翼状胬肉
欧阳先明	黔东南州人民医院	眼外伤职业眼病杂志	羊膜移植重建眼表在基层医院的应用
欧阳和木	龙海市第二医院眼科	中国实用眼科杂志	红眼病治疗用安乃近过敏致死一例
欧阳玲	深圳市眼科医院	临床眼科杂志	干眼对白内障手术的影响及其治疗方法
武俊林	甘肃省高台县人民医院眼科	眼外伤职业眼病杂志	头发焗油致过敏性结膜炎120例报告
武变英	河北职工医学院病理生理教研室	中华实验眼科杂志	术中应用丝裂霉素C治疗翼状胬肉实验和临床研究
武宇影	首都医科大学附属同仁医院眼科中心	中国中医眼科杂志	珍芪滴眼液治疗慢性结膜炎的实验研究
武海玲	海西州人民医院眼科	眼外伤职业眼病杂志	白内障患者非手术眼发生碘伏过敏性角结膜炎16例报告
段国平	湖南省人民医院眼科	中国中医眼科杂志	白内障术前清洁结膜囊方法的比较
段少英	中國河北省邢臺市眼科醫院跟科	国际眼科杂志	中西醫結合治瘵特异性幹眼癥
段志娟	邯郸市眼科医院	眼外伤职业眼病杂志	泪道冲洗碘必殊眼膏注入联合按压治疗泪小管炎
段直光	云南省大理州人民医院眼科	眼外伤职业眼病杂志	眼外伤及眼表疾病自体角膜缘干细胞移植术
段直光	云南省大理白族自治州人民医院眼科	临床眼科杂志	翼状胬肉与角膜散光的关系初步报告
段直光	大理州医院	眼外伤职业眼病杂志	羊膜移植联合丝裂霉素C防止翼状胬肉术后复发
殷学军	兰州军区乌鲁木齐总医院眼科	中华实验眼科杂志	维汉民族中学生沙眼衣原体感染调查
殷学军	兰州军区乌鲁木齐总医院	中华实验眼科杂志	沙眼衣原体两种基因诊断方法的比较
殷汝桂	复旦大学附属眼耳鼻喉科医院	临床眼科杂志	羊膜移植重建眼表的随访报告
殷汝桂	复旦大学医学院眼耳鼻喉科医院	中国实用眼科杂志	翼状胬肉手术对改善角膜散光及曲率的临床研究
殷海泉	阜新市中心医院	中国实用眼科杂志	重视眼科影像学检查提高临床诊断率
毋艳君	安阳市眼科医院	眼外伤职业眼病杂志	羊膜移植在翼状胬肉手术中的应用
毕国风	山东省威海市文登中心医院眼科	中国眼耳鼻喉科杂志	文登沿海乡镇中老年翼状胬肉的流行病学特点
毕延峰	温州医学院附属眼视光医院	中国实用眼科杂志	应用活体共焦显微镜观察翼状胬肉组织结构
毕江江	华中科技大学同济医学院附属同济医院眼科	中华眼科杂志	糖皮质激素性高眼压患者外周血单个核细胞糖皮质激素受体α和β的表达
毕燕龙	同济大学附属同济医院眼科	眼外伤职业眼病杂志	前段光学相干断层成像测量翼状胬肉术后结膜植片厚度的临床研究
毕苏欣	广东省中山火炬开发区医院眼科	国际眼科杂志	不同手术方式对翼状胬肉患者泪液功能的影响
毕颖文	复旦大学附属眼耳鼻喉科医院	中华眼科杂志	眼部自然杀伤-T细胞淋巴瘤致角膜穿孔一例
毛伟	宁波市江东眼科医院	中国中医眼科杂志	近视眼LASIK手术后角膜上皮铁线的临床观察
毛剑	江汉油田总医院	眼外伤职业眼病杂志	新鲜羊膜和生物冻干羊膜移植治疗复发性翼状胬肉
毛剑	江汉油田总医院眼科	国际眼科杂志	生物冻干羊膜移植在复发性翼状胬肉手术中的应用观察
毛思红	衢州市人民医院眼科	眼外伤职业眼病杂志	翼状胬肉撕离联合角膜缘干细胞移植的研究
毛晓春	华中科技大学同济医学院附属同济医院眼科	中华实验眼科杂志	β-NGF对人翼状胬肉成纤维细胞增生的影响
毛晓霞	江苏省海门市人民医院眼科	临床眼科杂志	手术显微镜下大范围切除联合羊膜移植治疗复发性翼状胬肉
毛真	中山大学中山眼科中心眼科学国家重点实验室	中华眼科杂志	透明质酸钠对兔含苯扎氯铵溴莫尼定眼表毒性保护作用的研究
汝亚琴	甘肃省康复中心医院眼科中心	国际眼科杂志	平阳霉素注射治疗翼状胬肉的临床观察
江军	淮南新华医院集团新华医院眼科	临床眼科杂志	淮南市煤矿工人翼状胬肉患病率的流行病学调查
江利红	上海杨浦区市东医院眼科	国际眼科杂志	翼状胬肉切除联合自体球结膜瓣移植术的临床分析
江天章	中国南京大学附属鼓楼医院眼科	国际眼科杂志	盐酸洛美沙星眼凝胶临床生物等效性试验
江文	核工业四一六医院眼科	国际眼科杂志	翼状胬肉术后90Srβ射线敷贴治疗疗效观察及复发相关因素分析
江睿	复旦大学附属眼耳鼻喉科医院眼科	中国眼耳鼻喉科杂志	试题与答案
江萍	湖北省宜昌市中心人民医院眼视光学中心	国际眼科杂志	高频治疗仪治疗巨乳头性结膜炎的临床观察
江萍	中国湖北省宜昌市中心人民医院视光学专科	国际眼科杂志	LASIK手术与翼状胬肉相互影响的探讨
汤代文	安徽省安庆市第一人民医院眼科	临床眼科杂志	生物羊膜联合自体角膜缘上皮干细胞移植在难治性翼状胬肉中的疗效研究
汤代文	安徽省安庆市第一人民医院眼科	临床眼科杂志	自体角膜缘上皮移植术与单纯切除治疗翼状胬肉的对比分析
汤学付	湖北省十堰市东风汽车公司茅箭医院眼科	眼外伤职业眼病杂志	翼状胬肉术后复发的防治探讨
汤景龙	杨州大学医学院附属医院	中国中医眼科杂志	视康滴眼液的药效学研究
汤欣	天津医科大学眼科中心	中国实用眼科杂志	人工角膜的新发展与新模型的临床评估
汤爱菊	广东省三水市人民医院眼科	中国实用眼科杂志	自体和异体角膜缘联合羊膜移植治疗难治翼状胬肉的研究
汪冬	浙江省舟山市普陀人民医院眼科	中国中医眼科杂志	翼状胬肉切除术后辅用中药的疗效观察
汪宁	安徽省马鞍山市马钢医院眼科	临床眼科杂志	羊膜移植治疗翼状胬肉临床疗效观察
汪彩芝	中国广东省深圳市西乡人民医院眼科	国际眼科杂志	裂隙灯眼前段处理系统在眼科的临床应用
汪振夏	上海市金山区漕泾镇卫生院眼科	眼外伤职业眼病杂志	较高浓度丝裂霉素C在胬肉切除术中的应用
汪毅	复旦大学附属眼耳鼻喉科医院耳鼻喉科	中国眼耳鼻喉科杂志	不同螨致敏原对变应性鼻炎患者生活质量的影响
汪洁	中国云南省第一人民医院眼科	国际眼科杂志	广泛切除联合术后丝裂霉素C滴眼治疗翼状胬肉
汪瑞娟	暨南大学医学院深圳眼科中心深圳市眼科医院	国际眼科杂志	翼状胬肉眼使用电脑验光和视网膜检影测定散光的对比研究
汪红	第三军医大学大坪医院眼科	中华实验眼科杂志	不同质量浓度MMC在翼状胬肉切除术中应用的比较
汪红	第三军医大学大坪医院眼科	临床眼科杂志	丝裂霉素C在翼状胬肉切除术中应用探讨
汪美华	中国人民解放军第一八○医院眼科	国际眼科杂志	翼状胬肉切除联合角膜缘干细胞移植术前术后的泪膜变化
汪育文	温州医学院眼视光学院	中国实用眼科杂志	高透氧性硬性角膜接触镜治疗屈光参差性弱视的疗效评估
汪英姿	上海市吴泾医院眼科	临床眼科杂志	羊膜移植重建眼表的随访报告
汪英姿	闵行区吴泾医院	眼外伤职业眼病杂志	羊膜移植或联合自体角膜缘移植治疗翼状胬肉
汪英姿	上海市吴泾医院眼科	临床眼科杂志	自体角膜缘干细胞移植联合羊膜移植治疗复发性翼状胬肉
汪英姿	上海市吴泾医院眼科	眼外伤职业眼病杂志	生物羊膜或结膜移植治疗翼状胬肉的效果比较
汪鑫	青岛大学医学院附属医院眼科	国际眼科杂志	翼状胬肉患者手术前后泪膜功能的变化
汪静	湖北省中山医院眼科	国际眼科杂志	夜戴型角膜塑形镜矫治儿童屈光参差疗效分析
沈丽珍	义乌市中医院眼科	中国中医眼科杂志	加味导赤散联合球结膜转位术治疗复发性翼状胬肉
沈丽珍	浙江省义乌市中医院眼科	眼外伤职业眼病杂志	翼状胬肉术后急性眼压升高二例报告
沈亚君	湖北省中山医院眼科	中华实验眼科杂志	盐酸奥洛他定联合环孢素A治疗特应性角膜结膜炎临床观察
沈伟	苏州大学附属一院眼科	国际眼科杂志	MMP-8在翼状胬肉中的表达
沈希成	浙江中医学院附属第三医院、金华市中医院眼科	眼外伤职业眼病杂志	带角膜缘上皮球结膜移植治疗翼状胬肉临床观察
沈惠	山东省日照市人民医院眼科	中国眼耳鼻喉科杂志	带环形巩膜瓣全角膜板层移植术治疗角膜表面衰竭
沈林雄	湖南省岳阳市三人民医院眼科	中国眼耳鼻喉科杂志	翼状胬肉逆行切除联合自体结膜或角膜缘干细胞移植术的疗效观察
沈泽民	上海交通大学医学院附属第三人民医院眼科	中国实用眼科杂志	表面麻醉在胬肉切除联合自体角膜缘干细胞移植术中的效果观察
沈炜	第二军医大学附属长海医院眼科	国际眼科杂志	转化生长因子β及其受体在翼状胬肉中基因表达的定量检测
沈炜	中国上海第二军医大学附属长海医院	国际眼科杂志	胬肉切除联合球结膜瓣转位术的疗效
沈玺	上海交通大学附属瑞金医院眼科	中华实验眼科杂志	异位性皮炎的眼部并发症
沈肇萌	浙江宁波李惠利医院眼科	中国实用眼科杂志	塑料薄膜在翼状胬肉手术中的应用
沈自芳	上海市浦东新区人民医院眼科	中国实用眼科杂志	翼状胬肉手术对改善角膜散光及曲率的临床研究
沈银忠	上海市公共卫生临床中心	中华眼视光学与视觉科学杂志	上海市艾滋病初诊患者眼部并发症及致盲原因调查分析
沙倩	中国黑龙江省哈尔滨市	国际眼科杂志	两种自体结膜移植术治疗原发翼状胬肉疗效比较
沙翔垠	广州医学院第二附属医院眼科	中华实验眼科杂志	广东地区变应性结膜炎变应原筛选及预防
沙翔垠	广州医学院第二附属医院眼科	中国实用眼科杂志	翼状胬肉根治手术预防复发的效果观察
沙翔垠	广州医学院第二附属医院眼科	中国实用眼科杂志	螨脱敏治疗变应性结膜炎的观察
沙翔垠	广州医学院第二附属医院眼科	中华眼科杂志	翼状胬肉显微手术方法及其疗效观察
沙莎	湖南省涟源市涟邵矿务局总医院眼科	眼外伤职业眼病杂志	丝裂霉素C在翼状胬肉术中的应用
洛桑	西藏军区总医院眼科	眼外伤职业眼病杂志	高原低气压环境相关特殊眼外伤的防治
洛桑	西藏军区总医院眼科	眼外伤职业眼病杂志	长时间存留的前房角异物摘出一例
洪丽娜	嘉兴市第二医院眼科	中国实用眼科杂志	视网膜母细胞瘤球壁外转移1例
洪佳旭	复旦大学附属眼耳鼻喉科医院眼科	中华眼科杂志	激光共聚焦显微镜观察春季角结膜炎患者的角膜形态变化
洪佳旭	复旦大学附属眼耳鼻喉科医院	中华眼科杂志	眼部自然杀伤-T细胞淋巴瘤致角膜穿孔一例
洪华山	福建省南安市英都中心卫生院眼科	中国中医眼科杂志	翼状胬肉手术前后与屈光变化的观察
洪卫	大理学院附属医院眼科大理学院临床医学研究中心	国际眼科杂志	青少年糖皮质激素性青光眼10例临床分析
洪建国	福建省南安市英都中心卫生院眼科	中国中医眼科杂志	翼状胬肉手术前后与屈光变化的观察
洪彬	浙江省台州医院路桥院区眼科	临床眼科杂志	80例干眼症临床分析
洪慧	首都医科大学附属北京友谊医院	眼外伤职业眼病杂志	自体角膜缘移植联合球结膜移植治疗翼状胬肉
洪晶	北京大学第三医院北京大学眼科中心	中华眼科杂志	慢性结膜炎患者泪液中腺病毒与单纯疱疹病毒的检测
洪流	中国江苏省姜堰市人民医院眼科	国际眼科杂志	自体角膜缘干细胞移植联合MMC治疗翼状胬肉疗效观察
洪瑾	中国人民解放军第81医院眼科	国际眼科杂志	Stevens-Johnson综合征1例
洪秀英	祁门县灯塔眼科医院	眼外伤职业眼病杂志	不同术式治疗翼状胬肉临床观察
涂昌森	福建医科大学附属第一医院眼科	国际眼科杂志	温州市农村防盲治盲情况调查与分析
温举川	甘肃天水市第一人民医院眼科	中国中医眼科杂志	新鲜羊膜移植治疗眼表疾病的临床观察
温新富	中国人民解放军425医院眼科	国际眼科杂志	三亚市郊≥50岁人群低视力及盲流行病学调查
温新富	中国海南省三亚市425医院眼科	国际眼科杂志	角膜缘干细胞移植治疗复发性翼状胬肉的疗效观察
温树灶	中山大学中山眼科中心	中国实用眼科杂志	碱性成纤维细胞生长因子治疗Sjogren综合征和非Sjogren水液缺乏性干眼疗效观察
温臣婷	华中科技大学同济医学院附属协和医院眼科	国际眼科杂志	紫杉醇对体外人翼状胬肉成纤维细胞的抑制作用
温臣婷	华中科技大学同济医学院附属协和医院眼科	临床眼科杂志	春季角结膜炎乳头病变研究及其治疗的进展
温贤忠	广东省职业病防治院	眼外伤职业眼病杂志	视屏终端作业对视疲劳影响的调查
游启生	首都医科大学附属北京同仁医院跟科中心北京市眼科研究所	眼科	北京农村老年居民翼状胬肉患病情况分析
滕兆娥	山东省五莲县人民医院眼科	临床眼科杂志	带环形巩膜瓣及角膜缘的全角膜板层移植术治疗蚕蚀性角膜溃疡
滕兆娥	山东省日照市人民医院眼科	中国眼耳鼻喉科杂志	带环形巩膜瓣全角膜板层移植术治疗角膜表面衰竭
滕玉明	中国人民解放军第四○四医院眼科	中国眼耳鼻喉科杂志	自体角膜缘干细胞移植术治疗翼状胬肉80例
潘剑国	巍山县医院眼科	眼科	微波热凝预防翼状胬肉术后复发
潘剑国	云南省巍山县人民医院眼科	眼外伤职业眼病杂志	干扰素联合结膜移植预防翼状胬肉术后复发
潘建兵	浙江省温岭市第四人民医院眼科	中华实验眼科杂志	环孢素A在防止翼状胬肉术后复发中作用的meta分析
潘志强	首都医科大学附属北京同仁医院	中华眼科杂志	沙眼衣原体--发现与贡献
潘志强	首都医科大学附属同仁眼科中心	眼科	翼状胬肉大小与角膜地形图的相关性研究
潘志强	首都医科大学附属北京同仁医院	中华眼科杂志	重视调控眼免疫稳定的调节性T细胞
潘志强	首都医科大学同仁医院眼科中心	中国实用眼科杂志	自体骨髓间充质干细胞移植改善重度眼表损伤临床观察
潘春晓	安徽省凤台县人民医院眼科	临床眼科杂志	自体角膜缘干细胞移植治疗翼状胬肉
潘晓晶	青岛大学医学院附属医院眼科	中华实验眼科杂志	1％阿奇霉素滴眼液治疗细菌性结膜炎的随机、双盲、临床对照试验
潘曼	广西北海市合浦卫校附院眼科	眼外伤职业眼病杂志	新鲜人羊膜移植在重建眼表结构中的临床应用
潘杰英	山东省德州市人民医院眼科	眼外伤职业眼病杂志	逆行切除联合巩膜裸露区烧灼治疗复发性翼状胬肉
潘杰英	德州市人民医院眼科	中国斜视与小儿眼科杂志	锋派新治疗新生儿淋菌性结膜炎
潘栋平	解放军第180医院眼科中心	国际眼科杂志	两种翼状胬肉切除手术的同体异眼比较
潘栋平	泉州市解放军第180医院眼科中心	中国实用眼科杂志	角膜缘干细胞移行遮盖法切除翼状胬肉
潘栋平	解放军第180医院眼科中心	国际眼科杂志	角膜缘干细胞滑行移植法切除翼状胬肉
潘海燕	黔东南州人民医院	眼外伤职业眼病杂志	羊膜移植重建眼表在基层医院的应用
潘竹娟	中山大学中山眼科中心国家重点实验室	国际眼科杂志	汉防己甲素体外对正常结膜与翼状胬肉成纤维细胞抑制作用的比较
潘竹娟	中国湖北省黄冈市第一人民医院眼科	国际眼科杂志	β-catenin在翼状胬肉成纤维细胞中的表达
潘竹娟	中山大学中山眼科中心	中国实用眼科杂志	正常球结膜与翼状胬肉成纤维细胞生长增殖状况的对比观察
潘美华	厦门眼科中心	中国斜视与小儿眼科杂志	厦门市思明区3～6岁儿童眼病调查
潘胜利	湖北医药学院附属太和医院眼科	临床眼科杂志	组织因子在人翼状胬肉中的表达
潘铭东	福建省人民医院眼科	中国中医眼科杂志	羊膜移植并除风益损汤加减治疗翼状胬肉
潘雅婕	上海中医药大学附属曙光医院	中国中医眼科杂志	翼状胬肉割烙术和胬肉切除联合羊膜移植术的疗效比较
潘青	江苏省宜兴市第二人民医院眼科	临床眼科杂志	两种手术治疗翼状胬肉的临床观察
焦万珍	山东大学附属省立医院眼科中心	中华眼科杂志	山东省滕州市2676名农村小学生沙眼患病调查
焦剑	北京大学航天中心医院眼科	临床眼科杂志	翼状胬肉切除术后巩膜溶解1例
焦海燕	中國吉林省四平市中心醫院眼科	国际眼科杂志	自體眼表移植術治瘵翼狀胬肉
焦秦	上海交通大学附属瑞金医院眼科	中华实验眼科杂志	异位性皮炎的眼部并发症
焦贵昕	辽宁省盘锦市第一人民医院眼科	眼外伤职业眼病杂志	结膜移植治疗翼状胬肉
熊全臣	中国西安交通大学第二医院眼科	国际眼科杂志	自体角膜缘移植联合新鲜羊膜治疗复发性翼状胬肉
熊全臣	西安交通大学医学院第二附属医院眼科	中华眼科杂志	加替沙星和左氧氟沙星治疗细菌性结膜炎的疗效对比研究
熊志强	广东省人民医院电脑室	中国实用眼科杂志	冬季广州市眼科门诊病人眼病构成情况调查
熊新春	同济医科大学附属协和医院眼科	眼科	干扰素α-2b对结膜下成纤维细胞生长形态的影响
熊毅	上海市宝山区宝山中心医院	眼外伤职业眼病杂志	羊膜移植与自体角膜缘干细胞移植治疗翼状胬肉的效果对比
熊毅	上海市曙光医院宝山分院	眼外伤职业眼病杂志	翼状胬肉术中改良的止血方法的临床观察
熊琦	武汉市第一医院眼科	中华实验眼科杂志	翼状胬肉中人乳头瘤病毒及单纯疱疹病毒的检测
熱依拉	，中國新疆獨山子石化總廠醫院眼科	国际眼科杂志	自體角膜緣幹細胞球結膜移植治療翼狀胬肉
熱依拉	中國新疆獨山子石化總廠醫院眼科	国际眼科杂志	翼狀胬肉切除結膜瓣轉移聯合β射綫照射72眼
燕振国	兰州军区兰州总医院眼科中心	中华眼科杂志	翼状胬肉切除联合结膜自体移植术中纤维蛋白胶应用的Meta分析
燕晓智	中国陕西省大荔县人民医院	国际眼科杂志	翼状胬肉两种手术治疗的比较
牛丽霞	山西省长治市人民医院	中国中医眼科杂志	角膜缘干细胞移植术和羊膜移植术治疗复发性翼状胬肉的比较
牛建军	兰州军区乌鲁木齐总医院眼科	中华实验眼科杂志	倍诺喜滴眼液致双眼严重角膜损害一例
牛晓霞	哈尔滨爱尔眼科医院	临床眼科杂志	翼状胬肉面积与角膜散光关系的分析研究
牟国营	山东省济南市中心医院眼科	临床眼科杂志	两种方法保存羊膜联合自体角膜缘移植治疗复发性翼状胬肉
牟国营	山东大学附属济南市中心医院	临床眼科杂志	角膜干细胞移植在翼状胬肉显微手术中的应用
牟国营	山东省济南市中心医院眼科	中国实用眼科杂志	翼状胬肉切除联合羊膜移植术临床应用
牟晓陆	中国陕西省扶风县人民医院眼科	国际眼科杂志	羊膜移植治疗眼表疾病的疗效观察
牟莉	徐州医学院附属医院眼科	临床眼科杂志	自体角膜缘干细胞联合羊膜移植治疗复发性翼状胬肉
牟莉	徐州医学院附属医院眼科	国际眼科杂志	三种不同术式治疗复发性翼状胬肉的疗效观察
独刚	兰州大学第二临床医学院	国际眼科杂志	甘肃省农村小学生沙眼快速评估的初步调查报告
王万辉	山西医科大学第二附属医院眼科	中国斜视与小儿眼科杂志	翼状胬肉患者泪液中表皮生长因子的含量分析
王世明	温州医学院附属眼视光医院	中华实验眼科杂志	Sj(o)gren综合征患者的角膜激光共焦显微镜活体观察
王世明	中国福建省泉州市儿童医院眼科	国际眼科杂志	两种翼状胬肉手术方式对角膜曲率影响的临床研究
王世雄	四川省会东县人民医院眼科	眼外伤职业眼病杂志	手术切除联合5-FU治疗翼状胬肉75例
王丽丽	中国陕西省榆林市星元医院眼科	国际眼科杂志	干眼症误诊的临床分析
王丽丽	中国陕西省西安市第四医院眼科	国际眼科杂志	角膜缘干细胞移植治疗翼状胬肉的疗效观察
王丽云	青岛经济开发区第一人民医院眼科	国际眼科杂志	干眼症的临床分析
王丽娅	河南省眼科研究所	中华实验眼科杂志	盐酸左氧氟沙星滴眼液治疗细菌性结膜炎及角膜炎随机双盲对照临床研究
王丽娟	青州眼科医院潍坊医学院卫生统计学教研室	中国实用眼科杂志	青州市农村≥60岁居民眼疾病状况及未就诊影响因素分析
王丽波	中国江苏省昆山市第一人民医院	国际眼科杂志	VEGF、CD34、Ki-67和p21在翼状胬肉中的表达及意义
王丽纯	郑州市第二人民医院眼科	中国实用眼科杂志	阿托品联合双焦镜控制青少年轻中度近视疗效分析
王乙婷	深圳市宝安区人民医院眼科	眼外伤职业眼病杂志	翼状胬肉自体角膜缘干细胞移植术
王乙迪	首都医科大学附属北京同仁医院北京同仁眼科中心	眼外伤职业眼病杂志	保留眼球的改良美容性全结膜瓣遮盖术
王云	镇平县公疗医院	眼外伤职业眼病杂志	平阳霉素治疗翼状胬肉的疗效观察
王云华	武汉大学中南医院眼科	国际眼科杂志	综合治疗复发性翼状胬肉疗效观察
王亚萍	龙口市人民医院眼科	中国中医眼科杂志	翼状胬肉术后复发的早期临床表现——角膜上皮修复不良
王亦敏	山东省寿光市人民医院	眼外伤职业眼病杂志	角膜缘上皮双向转移联合丝裂霉素C治疗翼状胬肉
王伟	武警总医院眼科	国际眼科杂志	泪道阻塞部位的分布特点及相关因素的初步研究
王伟刚	河北廊坊中国石油中心医院	中国中医眼科杂志	VEGF与PCNA在翼状胬肉中的表达
王伟娟	天津市汉沽区医院	眼外伤职业眼病杂志	自体角膜缘上皮移植、羊膜移植与常规术式治疗翼状胬肉复发率的比较
王佑娟	四川大学华西医院眼科	国际眼科杂志	成都市767例干部体检眼科疾病构成分析
王作先	嘉兴市第二医院眼科	中国实用眼科杂志	视网膜母细胞瘤球壁外转移1例
王俐泓	中国广西壮族自治区北海市第二人民医院眼科	国际眼科杂志	以复视为首发症状的非斜视性复视的病因分析
王保君	新乡医学院第一附属医院眼科	国际眼科杂志	长期联合应用噻吗洛尔对结膜组织炎性反应的影响
王元贵	深圳广东边防武警总队医院眼科	眼外伤职业眼病杂志	排多癌防治翼状胬肉术后复发疗效观察
王元贵	武警广东边防总队医院眼科医疗中心	中国眼耳鼻喉科杂志	角膜缘干细胞移植治疗翼状胬肉
王兆艳	中国人民解放军总医院眼科中心	临床眼科杂志	翼状胬肉切除术后巩膜溶解1例
王兆艳	解放军总医院眼科	中国实用眼科杂志	上睑外侧退行性内翻对高龄老年人的影响
王全红	山西省肿瘤医院	中国实用眼科杂志	翼状胬肉中Ki-67和VEGF的表达
王兴兰	成武县人民医院中医科	中国中医眼科杂志	中西医结合治疗假膜性结膜炎
王兴荣	济南施尔明眼科医院	眼外伤职业眼病杂志	自体角膜缘干细胞移植术治疗翼状胬肉
王兵	山东省滕州市中心人民医院眼科	中华眼科杂志	山东省滕州市2676名农村小学生沙眼患病调查
王兵	山东滕州市中心人民医院眼科	中国眼耳鼻喉科杂志	钝性分离胬肉联合自体角膜缘移植治疗翼状胬肉
王冲	中国广东省深圳市南山区妇幼保健院	国际眼科杂志	环孢霉素A在防止翼状胬肉复发中的作用
王凤玲	浙江省平湖市第二人民医院眼科	中国实用眼科杂志	翼状胬肉保留球结膜头部转位术的临床分析
王凯	湖北省云梦县人民医院眼科	中华实验眼科杂志	来氟米特活性代谢物A77 1726对翼状胬肉成纤维细胞增生的影响
王刘英	安徽省安庆市第一人民医院眼科	临床眼科杂志	自体角膜缘上皮移植术与单纯切除治疗翼状胬肉的对比分析
王利华	山东大学附属省立医院眼科中心	中华眼科杂志	山东省滕州市2676名农村小学生沙眼患病调查
王利群	洛阳市中心医院	眼外伤职业眼病杂志	羊膜与自体角膜缘结膜移植治疗翼状胬肉疗效对比
王勇	郑州人民医院眼科	眼外伤职业眼病杂志	液氮冷冻治疗早期复发性翼状胬肉临床观察
王勇	华中科技大学同济医学院附属协和医院眼科	中华眼科杂志	重视翼状胬肉的基础与临床研究
王勤美	温州医学院附属眼视光医院	中华实验眼科杂志	Sj(o)gren综合征患者的角膜激光共焦显微镜活体观察
王华	厦门大学眼科研究所	中华眼科杂志	努力提高我国翼状胬肉的手术水平
王博	郑州市第二人民医院眼科	眼外伤职业眼病杂志	翼状胬肉手术中无缝线自体角膜缘干细胞移植
王卫红	泰兴市中医院	中国中医眼科杂志	穿琥宁治疗流行性角膜结膜炎
王印其	河南省眼科研究所	中华实验眼科杂志	盐酸左氧氟沙星滴眼液治疗细菌性结膜炎及角膜炎随机双盲对照临床研究
王友法	江苏省中医院眼科中心	临床眼科杂志	不同激素浓度对预防翼状胬肉术后复发的临床观察
王咏梅	南通医学院第二附属医院眼科	眼科	单层或多层羊膜移植治疗眼表疾病
王善钊	山东省莘县眼科医院	中华眼视光学与视觉科学杂志	结膜囊吸吮线虫病五例
王国军	中国四川省广元市第四人民医院眼科	国际眼科杂志	自体角膜缘干细胞移植术治疗翼状胬肉的临床疗效观察
王国华	湖北省宜昌市中心人民医院	中国实用眼科杂志	结膜及睑板淀粉样变性一例
王培英	上海市吴泾医院眼科	临床眼科杂志	羊膜移植重建眼表的随访报告
王士奎	中國新疆兵圍農七師公安處門診	国际眼科杂志	翼狀胬肉切除結膜瓣轉移聯合β射綫照射72眼
王多春	中国疾病预防控制中心传染病所	中国实用眼科杂志	兰州地区细菌性结膜炎的致病菌分布和耐药性分析
王姝婷	山东省眼科研究所	中华实验眼科杂志	丝状角膜炎角膜丝状物构成分析
王娜玲	河南省平顶山市第一人民医院眼科	临床眼科杂志	慢性睑缘炎的临床特点及误诊分析
王娟	中国山东省青岛市经济技术开发区第一人民医院眼科	国际眼科杂志	翼状胬肉术后角膜融解2例临床分析
王娟	河北邯郸市眼科医院眼科	中国实用眼科杂志	翼状胬肉切除联合准分子激光治疗性角膜切削术与角膜缘干细胞移植术疗效对比观察
王婷	山东省眼科研究所	中华实验眼科杂志	丝状角膜炎角膜丝状物构成分析
王婷	山东大学附属省立医院眼科中心	中华眼科杂志	山东省滕州市2676名农村小学生沙眼患病调查
王婷婷	武警总医院眼科泪器病中心	中华眼科杂志	先天性无泪症伴鳄鱼泪一例
王婷婷	福建医科大学附属第一医院	国际眼科杂志	儿童春季卡他性角结膜炎与干眼症相关性分析
王婷婷	福建医科大学附属第一医院福建省眼科研究所	中国实用眼科杂志	翼状胬肉中细胞增殖与凋亡相关基因蛋白的表达及其意义
王媛	首都医科大学附属北京儿童医院眼科	中国斜视与小儿眼科杂志	Ritleng 泪道插管术治疗结膜炎导致的儿童继发性泪道阻塞疗效观察
王媛	暨南大学附属深圳眼科中心	国际眼科杂志	两种药物治疗变态反应性结膜炎的疗效观察
王学红	山东省威海市文登中心医院眼科	中国眼耳鼻喉科杂志	文登沿海乡镇中老年翼状胬肉的流行病学特点
王宏	兰州医学院第一附属医院	眼外伤职业眼病杂志	角膜缘干细胞移植或羊膜移植治疗翼状胬肉
王宏	兰州大学第一医院眼科	中国中医眼科杂志	自体角膜缘干细胞及羊膜对翼状胬肉TNF-α、IL-6表达的影响
王宏	河南省新乡市中心医院眼科	临床眼科杂志	翼状胬肉切除术联合局部注射地塞米松疗效观察
王宏刚	中国陕西省澄城县医院眼科	国际眼科杂志	翼状胬肉切除联合丝裂霉素C术后巩膜溶解的分析
王宗敏	温州医学院第二附属医院	中华眼视光学与视觉科学杂志	眼眶副节瘤1例
王宜强	省部共建国家重点实验室培育基地	中华实验眼科杂志	免疫刺激剂CpG ODN防治烟曲霉菌引起的变态反应性结膜炎的实验研究
王家伟	广东省佛山市禅城区中心医院眼科	中国眼耳鼻喉科杂志	翼状胬肉术后巩膜融解2例
王寅威	浙江省江山市中医院眼科	中国中医眼科杂志	结膜下非洲果蝇蛆1例
王富华	山东省眼科研究所山东省眼科医院	中华眼科杂志	翼状胬肉手术中慎用丝裂霉素C
王小强	天津医科大学眼科临床学院	中华实验眼科杂志	儿童急性结膜炎后长期干眼一例
王小琴	中南大学湘雅医学院附属海口医院	国际眼科杂志	逆行撕除法联合MMC及自体角膜缘干细胞移植治疗翼状胬肉
王峰	中國河北省邢臺市眼科醫院跟科	国际眼科杂志	中西醫結合治瘵特异性幹眼癥
王峰	西安交通大学第二附属医院眼科	国际眼科杂志	翼状胬肉在激光共焦显微镜下的观察研究
王峰	江苏丰县人民医院眼科	眼外伤职业眼病杂志	逆行切除结膜瓣转位治疗翼状胬肉173例
王巍	上海市浦东新区人民医院眼科	中国实用眼科杂志	翼状胬肉手术对改善角膜散光及曲率的临床研究
王庆华	无锡市第二人民医院眼科	中国实用眼科杂志	肉眼下翼状胬肉切除联合自体角膜缘干细胞移植临床分析
王康孙	上海交通大学医学院附属瑞金医院眼科	国际眼科杂志	高压氧治疗眼科应用进展
王康孙	上海第二医科大学附属瑞金医院眼科	中华眼科杂志	翼状胬肉中碱性成纤维细胞生长因子的表达及其与肥大细胞的关系
王康宏	海南医学院附属医院	眼外伤职业眼病杂志	两种术式联合丝裂霉素C治疗翼状胬肉
王建华	寿光市人民医院	眼科	Behcet病角膜溃疡穿孔误诊一例
王建华	山东省寿光市人民医院	眼外伤职业眼病杂志	角膜缘上皮双向转移联合丝裂霉素C治疗翼状胬肉
王建强	江苏省徐州市铁路医院眼科	眼外伤职业眼病杂志	自体角膜缘干细胞移植治疗复发性翼状胬肉
王建英	中國河北省邢臺市眼科醫院跟科	国际眼科杂志	中西醫結合治瘵特异性幹眼癥
王开丽	海南省人民医院	眼外伤职业眼病杂志	辅用丝裂霉素的巩膜暴露法翼状胬肉手术
王开文	广东省佛山市第二人民医院眼科	临床眼科杂志	85例眼红斑痤疮临床分析
王开文	石河子大学医学院第一附属医眼科	临床眼科杂志	眼红斑痤疮111例临床分析
王彦	河南省洛阳市第一人民医院眼科	中华实验眼科杂志	双眼结膜淀粉样变性一例
王彦荣	中国陕西省延安市人民医院眼科	国际眼科杂志	复发性翼状胬肉逆行切除包埋加自体角膜缘干细胞移植术疗效观察
王彩霞	长垣县人民医院	眼外伤职业眼病杂志	羊膜移植治疗翼状胬肉的临床疗效
王志斌	湖北省十堰市太和医院眼科	中华眼科杂志	门诊重症沙眼患者的有关因素调查
王志立	河南省眼科研究所	中华实验眼科杂志	早产儿眼病的特征分析
王志红	德州市人民医院眼科	中国斜视与小儿眼科杂志	锋派新治疗新生儿淋菌性结膜炎
王志良	上海交通大学医学院附属第九人民医院眼科上海交通大学医学院眼科视觉科学研究所	中华眼视光学与视觉科学杂志	上海市艾滋病初诊患者眼部并发症及致盲原因调查分析
王恩荣	松原市中心医院	眼外伤职业眼病杂志	结膜囊肿44例治疗分析
王惠云	宁波市鄞州人民医院	中国实用眼科杂志	翼状胬肉不同术式效果观察
王慧	云南省第二人民医院	国际眼科杂志	角膜缘干细胞移植联合羊膜移植治疗复发性翼状胬肉睑球粘连
王懿	中国江苏省昆山市第一人民医院	国际眼科杂志	VEGF、CD34、Ki-67和p21在翼状胬肉中的表达及意义
王振	山东大学附属济南市中心医院	临床眼科杂志	角膜干细胞移植在翼状胬肉显微手术中的应用
王振亮	中国福建省泉州市儿童医院眼科	国际眼科杂志	两种翼状胬肉手术方式对角膜曲率影响的临床研究
王振军	郑州市第二人民医院眼科	临床眼科杂志	保存人羊膜和自体角膜缘移植术治疗复发性翼状胬肉临床观察
王改欣	中国河北省石家庄市第二医院眼科	国际眼科杂志	带蒂结膜瓣转位移植治疗翼状胬肉
王效武	中国山西省眼科医院角膜科	国际眼科杂志	巩膜暴露法联合术中应用丝裂霉素C治疗双头翼状胬肉
王效武	山西省眼科医院	中国斜视与小儿眼科杂志	儿童泡性眼炎病因分析及治疗
王敏華	中國廣州中山醫科大學中山眼科中心	国际眼科杂志	羊膜移植治療翼狀胬肉
王敬明	中国陕西省榆林市第二医院眼科	国际眼科杂志	翼状胬肉手术中应用羊膜移植联合丝裂霉素48眼
王敬明	中国陕西省榆林市第二医院眼科	国际眼科杂志	新鲜羊膜移植治疗眼表疾病89例
王文	北京博雅康泰生物工程科技有限公司	中国中医眼科杂志	秦菊滴眼液治疗家兔实验性结膜炎的实验研究
王文奇	中国江苏省淮安市第一人民医院眼科	国际眼科杂志	自体角膜缘干细胞移植和自体游离球结膜移植治疗翼状胬肉的疗效观察
王文玲	安阳市眼科医院	眼外伤职业眼病杂志	羊膜移植在翼状胬肉手术中的应用
王文莹	首都医科大学附属北京同仁医院眼科中心	国际眼科杂志	精神压力与心因性结膜炎58例的心理治疗
王文韬	复旦大学附属眼耳鼻喉科医院	中国实用眼科杂志	双氯芬酸钠透明质酸钠滴眼液治疗急性变态反应性结膜炎评价
王文韬	复旦大学附属眼耳鼻喉科医院	中华眼视光学与视觉科学杂志	0.1%普拉洛芬滴眼液治疗急性变态反应性结膜炎的疗效
王旌	复旦大学附属眼耳鼻喉科医院眼科	中华眼底病杂志	经双目间接检眼镜激光光凝治疗严重早产儿视网膜病变
王时力	台州市中心医院	眼外伤职业眼病杂志	结膜乳头切除加丝裂霉素C治疗春季角结膜炎
王时力	浙江省台州市中心医院眼科	中国中医眼科杂志	翼状胬肉患者手术前后泪膜功能的变化
王明	河南省信阳市中心医院眼科	中华实验眼科杂志	沙眼性角膜瘢痕合并老年性白内障人工晶状体植入32例手术体会
王明俭	天津市第四中心医院眼科	中国实用眼科杂志	自体角膜上皮移植治疗翼状胬肉
王昕	河南医科大学第四附属医院	眼外伤职业眼病杂志	丝裂霉素C应用于翼状胬肉切除术的研究
王昕华	中国辽宁省沈阳市第四人民医院眼科门诊	国际眼科杂志	眼内手术后病毒性角膜炎临床分析
王星	辽宁省抚顺市眼病医院	临床眼科杂志	巩膜暴露区板层角膜移植治疗复发性翼状胬肉
王星	中国辽宁省抚顺市眼病医院	国际眼科杂志	自体干细胞移植联合丝裂霉素C治疗翼状胬肉的临床观察
王映芬	广东医学院附属医院眼科	中华实验眼科杂志	5F对人翼状胬肉成纤维细胞增生及Fas表达的调控
王映芬	广东医学院附属医院眼科	中国中医眼科杂志	高三尖杉酯碱和血栓通对人翼状胬肉成纤维细胞周期性变化的影响
王映芬	广东医学院附属医院眼科	中华实验眼科杂志	PCNA和bcl-2在翼状胬肉成纤维细胞中的表达及蝮蛇抗栓酶的影响
王映芬	广东医学院附属医院眼科	中国中医眼科杂志	半边旗二萜类化合物5F对人翼状胬肉成纤维细胞增殖的抑制作用
王映芬	广东医学院附属医院眼科	眼科	半边旗二萜类化合物5F对人翼状胬肉成纤维细胞增殖周期和Ki-67表达的影响
王映芬	广东医学院附属医院眼科	中华实验眼科杂志	丝裂霉素C抗人翼状胬肉成纤维细胞增殖的实验研究
王映芬	广东医学院附属医院	中华眼视光学与视觉科学杂志	蝮蛇抗栓酶对人翼状胬肉成纤维细胞增殖效果的影响
王春兰	神木县眼科医院	眼外伤职业眼病杂志	眼部碱烧伤相关因素分析
王春梅	中國西安兵器工業521醫院眼科	国际眼科杂志	自體角膜缘上皮移植聯合缘裂霉素C治瘵翼狀胬肉的臨床觀察
王春水	山东省寿光市人民医院	眼外伤职业眼病杂志	角膜缘上皮双向转移联合丝裂霉素C治疗翼状胬肉
王春花	山西医科大学第一医院耳鼻咽喉科变态反应室	中华眼科杂志	过敏性结膜炎变应原检查
王显江	山东省烟台经济技术开发区医院	临床眼科杂志	刮除上皮联合接触镜治疗点状角膜炎1例
王晋瑛	中国湖北省武汉市第一医院眼科	国际眼科杂志	氩激光治疗翼状胬肉疗效分析
王晓东	江苏省江阴市中医院眼科	临床眼科杂志	金银花汤剂眼浴治疗卡他性结膜炎疗效观察
王晓幸	温州医学院附属眼视光医院	中华眼视光学与视觉科学杂志	翼状胬肉逆行切除加羊膜移植的临床疗效
王晓春	山东省枣庄市立医院眼科	中国眼耳鼻喉科杂志	翼状胬肉切除联合自体结膜移植术疗效观察
王晓琴	华中科技大学附属荆州医院（荆州市中心医院）眼科	中国实用眼科杂志	翼状胬肉显微切除联合丝裂霉素C加自体带角膜缘上皮结膜移植术观察
王晓辉	福建医科大学附属第一医院眼科	国际眼科杂志	干眼症83例病因诊断与误诊分析
王智	辽宁省营口市中心医院眼科	临床眼科杂志	翼状胬肉切除术后并发结膜囊肿的临床治疗观察
王智崇	中山大学中山眼科中心	中国实用眼科杂志	FK506局部治疗顽固性春季角结膜炎
王智崇	中山大学中山眼科中心	眼科	奥洛他定联合FK506滴眼液治疗儿童严重春季角结膜炎的疗效观察
王智崇	中山大学中山眼科中心	中华眼科杂志	羊膜移植重建静止期眼结膜表面的远期疗效分析
王智彪	黔南州人民医院	眼外伤职业眼病杂志	下方带蒂角膜缘上皮移植治疗翼状胬肉
王智群	首都医科大学附属同仁医院	中华实验眼科杂志	武强县小学生沙眼流行病学调查
王智群	同仁眼科中心北京市眼科研究所	中华实验眼科杂志	我国北方两地区小学生沙眼衣原体检测及基因分型研究
王智群	北京市眼科学与视觉科学重点实验室	中华实验眼科杂志	沙眼患者病原体基因型的鉴定分析
王智群	首都医科大学附属北京同仁医院眼科中心	眼科	沙眼患者临床与实验室诊断研究
王智群	北京市眼科研究所微生物室	中华眼视光学与视觉科学杂志	44例真菌性角结膜炎患者真菌培养及药敏试验结果分析
王曙红	江苏省淮安市第一人民医院眼科	临床眼科杂志	自体上方球结膜瓣转位治疗翼状胬肉疗效观察
王朋	武警总医院眼科泪器病中心	中华眼科杂志	先天性无泪症伴鳄鱼泪一例
王朝峰	武城县中医院	眼外伤职业眼病杂志	复发性翼状胬肉的综合治疗及临床观察
王柏川	中国湖北武汉广州军区武汉总医院眼科	国际眼科杂志	自体角膜缘上皮联合羊膜移植治疗眼表疾病
王桂琴	海军总医院眼科	中华眼科杂志	以伪膜性结膜炎为首发表现的水痘一例
王桂芳	解放军59中心医院眼科	临床眼科杂志	四头带加压致角膜后弹力层断裂2例
王梅	中山大学附属第二医院眼科	国际眼科杂志	逆行镊撕法联合3种手术方式预防翼状胬肉复发的疗效分析
王欢	天津市儿童医院眼科	中国斜视与小儿眼科杂志	420例儿童干眼的相关因素分析
王欣	复旦大学附属眼耳鼻喉科医院	中华眼视光学与视觉科学杂志	0.1%普拉洛芬滴眼液治疗急性变态反应性结膜炎的疗效
王欣	复旦大学附属眼耳鼻喉科医院	中国实用眼科杂志	双氯芬酸钠透明质酸钠滴眼液治疗急性变态反应性结膜炎评价
王欣	天津市眼科医院	中国中医眼科杂志	针刺对Sjogren综合征患者泪液的影响
王欣玲	中国医科大学附属第四医院眼科	国际眼科杂志	层黏连蛋白对人翼状胬肉成纤维细胞生长的抑制作用
王欣荣	中南大学湘雅三医院眼科	中国实用眼科杂志	XIAP和COX-2在翼状胬肉中的表达及其相关性研究
王正华	中国茂名市人民医院眼科	国际眼科杂志	新鲜羊膜移植治疗眼表疾病的临床观察
王毅	嘉兴学院医学院附属嘉兴市第一医院眼科	眼外伤职业眼病杂志	翼状胬肉手术前后屈光变化
王永强	河北省固安县医院眼科	中国中医眼科杂志	自体角膜缘干细胞移植治疗翼状胬肉临床分析
王永志	上海第二军医大学微生物教研室	国际眼科杂志	人翼状胬肉组织HMG-CoA还原酶和LDL受体基因的表达
王永毅	河南大学淮河医院眼科	中华实验眼科杂志	DNA氧化损伤在翼状胬肉发病中的作用
王永清	合肥市红十字会眼科医院	中国中医眼科杂志	冷冻配合归芍红花散治疗结膜淀粉样变性临床观察
王波	湖北省十堰市东风汽车公司茅箭医院眼科	眼外伤职业眼病杂志	翼状胬肉术后复发的防治探讨
王洪亮	河南南阳医专附院	眼外伤职业眼病杂志	新鲜羊膜移植治疗翼状胬肉的临床观察
王洪峰	松原市中心医院	眼外伤职业眼病杂志	结膜囊肿44例治疗分析
王洪格	青岛市市立医院眼科	中华实验眼科杂志	1％阿奇霉素滴眼液治疗细菌性结膜炎的随机、双盲、临床对照试验
王海涛	武汉大学中南医院眼科	国际眼科杂志	综合治疗复发性翼状胬肉疗效观察
王海蓉	甘肃省定西市第二人民医院眼科	眼外伤职业眼病杂志	翼状胬肉自体角膜缘干细胞移植手术
王海铭	中国湖北省武汉市	国际眼科杂志	自体角膜缘上皮移植治疗翼状胬肉78例
王涛	中山大学中山眼科中心	中华眼科杂志	急性结膜炎痊愈后泪膜的变化
王淑晶	长春八一医院	眼外伤职业眼病杂志	原发性翼状胬肉手术时机临床观察
王淑芬	河北医科大学第二医院眼科	中国实用眼科杂志	肺癌多脏器转移首诊眼科1例
王炜	中国中医科学院江苏分院眼科	国际眼科杂志	Vogt-小柳-原田综合征的临床误诊分析
王炳亮	安阳市眼科医院	眼外伤职业眼病杂志	双向角膜缘干细胞移植治疗翼状胬肉
王照祥	山东省临邑县人民医院眼科中心	眼外伤职业眼病杂志	角膜缘干细胞移植治疗复发性翼状胬肉
王爽	首都医科大学附属北京同仁医院跟科中心北京市眼科研究所	眼科	北京农村老年居民翼状胬肉患病情况分析
王玉倩	厦门大学附属厦门眼科中心	中华眼科杂志	睑板腺形态学的研究进展
王玉娟	中山大学中山眼科中心	中华眼科杂志	急性结膜炎痊愈后泪膜的变化
王玉珍	威海市文登中心医院	眼外伤职业眼病杂志	结膜囊异物误诊一例
王玉萍	兰州大学第二医院眼科	中国实用眼科杂志	兰州地区细菌性结膜炎的致病菌分布和耐药性分析
王玮	福建医科大学解剖学系	中国实用眼科杂志	系统性红斑狼疮患者眼表损害及相关抗体检测
王玲	海口市人民医院	眼外伤职业眼病杂志	自体角膜缘干细胞移植治疗翼状胬肉临床观察
王玲丽	郧阳医学院附属太和医院眼科	眼外伤职业眼病杂志	翼状胬肉埋藏法113例
王玲丽	湖北医药学院附属太和医院眼科	临床眼科杂志	翼状胬肉手术前后对比敏感度和角膜地形图改变的比较
王玲丽	湖北省十堰市太和医院眼科	中华眼科杂志	门诊重症沙眼患者的有关因素调查
王玲丽	湖北医药学院附属太和医院眼科	临床眼科杂志	初发性翼状胬肉术中单用利多卡因凝胶与丁卡因滴液表面麻醉效果对比分析
王珂	中国河北省邢台市眼科医院眼六科	国际眼科杂志	软性角膜接触镜在眼表疾病中的临床应用
王珂	陕西省人民医院眼科	眼外伤职业眼病杂志	翼状胬肉与角膜曲率
王理理	中国南京军区南京总医院眼科	国际眼科杂志	盐酸洛美沙星眼凝胶临床生物等效性试验
王琦妙	中日友好医院	中国中医眼科杂志	春季角结膜炎中医药治疗最新进展
王琼	四川大学华西医院眼科	国际眼科杂志	他克莫司治疗春季卡他性角结膜炎的疗效分析
王瑞	兰州军区乌鲁木齐总医院	中华实验眼科杂志	沙眼衣原体两种基因诊断方法的比较
王瑶	山东省眼科研究所	眼科	血管膜切除联合羊膜移植治疗复发性免疫性角结膜炎
王百川	广州军区武汉总医院	眼外伤职业眼病杂志	板层角膜联合羊膜移植治疗复发性翼状胬肉
王皓月	山东省滕州市中心人民医院眼科	中华眼科杂志	山东省滕州市2676名农村小学生沙眼患病调查
王砚颖	深圳市中医院	中国中医眼科杂志	化胬抑复冲剂降低翼状胬肉术后复发率的临床研究
王磊	中国医科大学附属盛京医院眼科	国际眼科杂志	蒲地蓝消炎口服液治疗流行性角结膜炎的临床疗效
王禹燕	成都中医药大学	中国中医眼科杂志	苦参碱对体外培养人翼状胬肉成纤维细胞增殖的影响
王秀	中国山东省青岛市经济技术开发区第一人民医院眼科	国际眼科杂志	翼状胬肉术后角膜融解2例临床分析
王秀珍	哈尔滨爱尔眼科医院	临床眼科杂志	翼状胬肉面积与角膜散光关系的分析研究
王秀青	重庆医科大学第二附属医院眼科	中国实用眼科杂志	两种矫正退行性下睑外翻手术方法效果比较
王秋旭	无锡第三人民医院	中华眼视光学与视觉科学杂志	三种衣原体感染与人类角膜结膜炎的关系
王素英	福建省南平市第一医院眼科	中国斜视与小儿眼科杂志	新生儿淋菌性结膜炎的临床分析
王红	北京同仁医院眼科	中国实用眼科杂志	过敏性结膜炎的临床特点
王红卫	驻马店高新区关王庙乡卫生院	眼外伤职业眼病杂志	翼状胬肉切除联合角膜缘干细胞移植术观察
王红民	驻马店市中心医院	眼外伤职业眼病杂志	重组人表皮生长因子在翼状胬肉术后的应用
王继岩	开滦医疗集团赵各庄医院眼科	国际眼科杂志	自体带蒂角膜缘干细胞移植术治疗翼状胬肉
王维	寿光市人民医院	眼科	Behcet病角膜溃疡穿孔误诊一例
王肖华	西安交通大学医学院第二附属医院眼科	国际眼科杂志	带蒂结膜瓣转移联合丝裂霉素C治疗复发性翼状胬肉的临床研究
王艳	复旦大学附属眼耳鼻喉科医院	中华眼视光学与视觉科学杂志	0.1%普拉洛芬滴眼液治疗急性变态反应性结膜炎的疗效
王艳	龙口市人民医院眼科	中国中医眼科杂志	翼状胬肉术后复发的早期临床表现——角膜上皮修复不良
王艳	复旦大学附属眼耳鼻喉科医院	中国实用眼科杂志	双氯芬酸钠透明质酸钠滴眼液治疗急性变态反应性结膜炎评价
王艳东	中国北京市平谷区医院眼科	国际眼科杂志	角膜缘干细胞移植治疗翼状胬肉的临床观察
王艳玲	首都医科大学附属北京友谊医院	眼外伤职业眼病杂志	自体角膜缘移植联合球结膜移植治疗翼状胬肉
王芳	解放军第一六三医院眼科	中华眼科杂志	翼状胬肉中诱导一氧化氮合酶与FⅧ相关抗原表达的研究
王芳	解放军第一六三医院眼科	中国实用眼科杂志	FⅧ-RAg VEGF在翼状胬肉中表达和微血管密度检测及其意义
王芳	武汉大学人民医院眼科	国际眼科杂志	角膜缘血管网切断联合生物羊膜移植治疗角膜新生血管
王英爽	中国黑龙江省哈尔滨市	国际眼科杂志	两种自体结膜移植术治疗原发翼状胬肉疗效比较
王荣光	北京同仁医院眼科	眼科	羊膜移植联合带结膜瓣自体角膜缘移植及丝裂霉素C治疗多次复发性翼状胬肉
王莉	深圳市儿童医院眼科	国际眼科杂志	FK506对实验性过敏性结膜炎细胞因子表达的影响
王莉	中国陕西省安康市中心医院眼科	国际眼科杂志	新鲜羊膜与生物羊膜移植治疗翼状胬肉的临床观察
王莉	中国陕西省安康市中心医院眼科	国际眼科杂志	羊膜移植联合自体角膜缘移植治疗角膜缘功能衰竭症
王莉	河南省巩义市人民医院眼科	眼外伤职业眼病杂志	平阳霉素治疗翼状胬肉十年疗效观察
王莉	深圳市儿童医院眼科	临床眼科杂志	累及眼部的Stevens-Johnson综合征1例
王莉莉	中国上海第二军医大学附属长海医院	国际眼科杂志	胬肉切除联合球结膜瓣转位术的疗效
王莲芸	山西医科大学第一医院耳鼻咽喉科变态反应室	中华眼科杂志	过敏性结膜炎变应原检查
王莹	郧阳医学院附属十堰市人民医院眼科	国际眼科杂志	YAG泪道激光联合丝裂霉素及典必殊眼膏治疗泪道阻塞89例
王菊	喀什农三师医院眼科	眼外伤职业眼病杂志	自体角膜缘干细胞移植治疗翼状胬肉148例
王薇	北京大学第三医院眼科	中华眼科杂志	泪道栓塞术治疗干眼症的临床效果
王薇	北京大学第三医院眼科中心	中华眼科杂志	翼状胬肉术后结膜印记细胞学及临床疗效观察
王超英	中国人民解放军白求恩国际和平医院眼科	国际眼科杂志	儿童频繁瞬目病因分析
王超英	解放军白求恩国际和平医院眼科	中华实验眼科杂志	睫毛刺入致结膜囊肿一例
王超英	南阳市第二人民医院眼科	中华实验眼科杂志	囊腔内注射治疗结膜囊肿32例
王跃丽	承德医学院附属医院	眼科	干眼症患病因素的临床分析
王达良	绍兴市人民医院	眼外伤职业眼病杂志	羊膜移植与角膜缘干细胞移植治疗翼状胬肉
王迎开	荣成市人民医院	眼外伤职业眼病杂志	翼状胬肉术中应用丝裂霉素C预防复发的观察
王迎开	山东省荣成市人民医院眼科	临床眼科杂志	荣成市渔民翼状胬肉的流行病学调查
王远	临颍县人民医院	眼外伤职业眼病杂志	新鲜羊膜移植治疗复发性翼状胬肉的效果观察
王适群	武汉市协和医院眼科	中华实验眼科杂志	翼状胬肉上皮细胞基质金属蛋白酶Ⅱ的表达
王适群	华中科技大学同济医学院附属协和医院眼科	中华实验眼科杂志	维生素E琥珀酸酯抑制人翼状胬肉成纤维细胞生长作用的研究
王铁成	天津医科大学眼科中心	国际眼科杂志	云南省怒江州贡山县翼状胬肉的流行病学调查
王锡夫	诸城市中医院眼科	中国中医眼科杂志	急性视网膜坏死误诊1例
王闰	黑龙江省佳木斯市中心医院眼科	中国眼耳鼻喉科杂志	环氧化酶2在翼状胬肉中的表达及意义
王雅东	兰州大学第二临床医学院	国际眼科杂志	甘肃省农村小学生沙眼快速评估的初步调查报告
王雨生	第四军医大学西京医院眼科全军眼科研究所	国际眼科杂志	体外培养自体角膜缘干细胞移植术治疗翼状胬肉1例
王雪飞	复旦大学附属华山医院南汇分院眼科	国际眼科杂志	翼状胬肉切除改良术式的临床观察
王雪飞	复旦大学附属华山医院南汇分院眼科	国际眼科杂志	翼状胬肉切除联合球结膜下生物羊膜移植的初步研究
王青	广东省中山火炬开发区医院眼科	国际眼科杂志	不同手术方式对翼状胬肉患者泪液功能的影响
王静	湖北省宜昌市中心人民医院眼视光学中心	国际眼科杂志	高频治疗仪治疗巨乳头性结膜炎的临床观察
王颖宾	临颍县人民医院	眼外伤职业眼病杂志	新鲜羊膜移植治疗复发性翼状胬肉的效果观察
王飞	中国河南省固始县人民医院眼科	国际眼科杂志	结膜角膜缘干细胞双向移行手术治疗翼状胬肉23例
王骞	郑州市第二人民医院	中国实用眼科杂志	丝状角膜炎的临床治疗观察
王鹭沙	福建泉州市儿童医院眼科	眼外伤职业眼病杂志	原发性翼状胬肉术中应用丝裂霉素C的临床观察及胬肉复发的分析
王黎波	兰州军区乌鲁木齐总医院眼科	中华实验眼科杂志	倍诺喜滴眼液致双眼严重角膜损害一例
王龙梅	山东省临沂市人民医院博爱眼科	中国实用眼科杂志	表面麻醉在胬肉切除联合自体角膜缘干细胞移植术中的效果观察
班景飞	邯郸市眼科医院	眼外伤职业眼病杂志	泪道冲洗碘必殊眼膏注入联合按压治疗泪小管炎
班爱荣	河南省伊川县医院眼科	眼外伤职业眼病杂志	带蒂结膜瓣移植术治疗翼状胬肉的临床观察
班爱荣	伊川县人民医院眼科	中华实验眼科杂志	双氯灭痛治疗春季结膜炎
琚怀民	安阳市眼科医院	眼外伤职业眼病杂志	双向角膜缘干细胞移植治疗翼状胬肉
甄兆忠	暨南大学医学院附属第四医院眼科	临床眼科杂志	托百士滴眼液治疗眼表细菌性炎症的疗效观察
甘露	四川大学华西医院眼科	国际眼科杂志	成都市767例干部体检眼科疾病构成分析
生侠	中南大学湘雅医学院附属海口医院	国际眼科杂志	逆行撕除法联合MMC及自体角膜缘干细胞移植治疗翼状胬肉
田农	南京大学医学院临床学院南京军区南京总医院眼科	中华实验眼科杂志	激光共焦显微镜与组织病理学对翼状胬肉组织中微血管密度研究的比较
田冰玉	中国陕西省西安市第四医院眼科	国际眼科杂志	医用生物蛋白胶联合角膜缘干细胞移植在复发性翼状胬肉治疗中的应用
田孟国	云南省巍山县人民医院眼科	眼外伤职业眼病杂志	干扰素联合结膜移植预防翼状胬肉术后复发
田密	湖南省儿童医院眼科	国际眼科杂志	婴幼儿泪囊炎的治疗综述
田晓燕	中国陕西省汉中市3201医院眼科	国际眼科杂志	新鲜羊膜移植治疗复发性翼状胬肉30例
田桂芬	河北省职工医学院附属医院眼科	眼科	部分切除并联合自体角膜上皮干细胞移植治疗翼状胬肉
田桂花	山东省德州市人民医院眼科	临床眼科杂志	季节过敏性和常年过敏性结膜炎的变应原检测及治疗分析
田涛	湖南省郴州市第三人民医院	中华眼视光学与视觉科学杂志	新鲜羊膜移植治疗翼状胬肉
田艳明	解放军273医院眼科	临床眼科杂志	逆行翼状胬肉切除法与顺行切除法对比分析
田英	河南医科大学第一附属医院眼科	眼外伤职业眼病杂志	开睑钩翻转眼睑用于沙眼手术的体会
田蔓男	兰州医学院第一附属医院	眼外伤职业眼病杂志	角膜缘干细胞移植或羊膜移植治疗翼状胬肉
田蔓男	兰州大学第一医院眼科	中国中医眼科杂志	自体角膜缘干细胞及羊膜对翼状胬肉TNF-α、IL-6表达的影响
田雷	山东省莱芜市中医院	中国中医眼科杂志	角膜缘干细胞移植联合胬肉切除术治疗翼状胬肉56例
田霞	山东省威海市文登中心医院眼科	中国眼耳鼻喉科杂志	文登沿海乡镇中老年翼状胬肉的流行病学特点
田静	兰州大学第二医院眼科	国际眼科杂志	甘肃舟曲县藏汉族小学生干眼症的流行病学调查
田骋	河南南阳医专附院	眼外伤职业眼病杂志	新鲜羊膜移植治疗翼状胬肉的临床观察
申令	北京市眼科学与视觉科学重点实验室	中华眼科杂志	上方角膜缘角结膜炎一例
申家泉	山东大学山东省立医院眼科	国际眼科杂志	沙眼防治的研究进展
申德昂	河南省汝南县人民医院眼科	中华眼科杂志	眼科手术后斜视和复视的临床分析
申文增	河北职工医学院病理生理教研室	中华实验眼科杂志	术中应用丝裂霉素C治疗翼状胬肉实验和临床研究
申海良	河北省邯郸市眼科医院	临床眼科杂志	超声乳化白内障摘除联合人工晶状体植入术后低视力原因分析
申煌煊	中山大学中山眼科中心遗传分子生物学实验室	临床眼科杂志	PCR扩增技术在新生儿结膜炎中的诊断应用
申育华	河北省邯郸市第三医院眼科	眼外伤职业眼病杂志	新鲜羊膜移植治疗复发性翼状胬肉
申长新	焦作市人民医院	眼外伤职业眼病杂志	羊膜移植治疗翼状胬肉及复发原因分析
白大勇	河南大学淮河医院	眼外伤职业眼病杂志	翼状胬肉三种手术方法的临床效果观察
白宗禧	西藏军区总医院眼科	眼外伤职业眼病杂志	长时间存留的前房角异物摘出一例
白宗禧	西藏军区总医院眼科	眼外伤职业眼病杂志	高原低气压环境相关特殊眼外伤的防治
白广明	安徽省淮南卫生学校附属医院眼科	临床眼科杂志	翼状胬肉切除结膜转位术后应用环磷酰胺的疗效观察
白玉辉	中国云南省红河州医院眼科	国际眼科杂志	自体带结膜瓣角膜缘干细胞移植治疗翼状胬肉
白琼珍	厦门大学附属厦门眼科中心	国际眼科杂志	翼状胬肉组织Caveolin-1,E-cadherin和P63的表达
白瑜	中国河北省石家庄市第二医院眼科	国际眼科杂志	带蒂结膜瓣转位移植治疗翼状胬肉
白继	第三军医大学大坪医院野战外科研究所眼科中心	中华实验眼科杂志	准分子激光在翼状胬肉治疗中的应用
白莎	中国四川省广元市第四人民医院眼科	国际眼科杂志	自体角膜缘干细胞移植术治疗翼状胬肉的临床疗效观察
百籁皓	日本财团法人临床眼科研究所	中国实用眼科杂志	冻干人羊膜治疗翼状胬肉的临床观察
皮裕琍	解放军总医院第304临床部眼科	中国实用眼科杂志	羊膜和角膜干细胞移植治疗眼表疾病临床观察
皮裕琍	解放军总医院304临床部眼科	国际眼科杂志	体外培养自体角膜缘干细胞移植术治疗翼状胬肉1例
皮裕	解放军总医院第一附属医院眼科	国际眼科杂志	自体角膜缘干细胞移植与自体体外培养角膜干细胞移植治疗翼状胬肉临床观察
盘如刚	四川大学华西医院眼科中心	国际眼科杂志	翼状胬肉切除、大范围Tenon囊切除联合丝裂霉素C治疗翼状胬肉的临床研究
盛传家	福州市第二医院病理科	中国实用眼科杂志	翼状胬肉的发生与角膜缘干细胞缺乏的病理研究
盛文	温州医学院附属眼视光医院	中华眼视光学与视觉科学杂志	眼眶副节瘤1例
盛耀華	中國上海第二醫科大學附屬新華醫院眼科	国际眼科杂志	頭孢三嗪噻肟治瘵淋菌性結膜炎42例
盛迅伦	青岛经济开发区第一人民医院眼科	国际眼科杂志	干眼症的临床分析
盛迅伦	宁夏回族自治区人民医院宁夏眼科医院	国际眼科杂志	宁夏地区翼状胬肉患病率的流行病学调查
盛迅伦	宁夏回族自治区人民医院宁夏眼科医院	国际眼科杂志	宁夏地区沙眼患病率流行病学调查
盛迅伦	中国山东省青岛市经济技术开发区第一人民医院眼科	国际眼科杂志	翼状胬肉术后角膜融解2例临床分析
瞿佳	温州医学院附属视光医院眼科	中华眼科杂志	加替沙星和左氧氟沙星治疗细菌性结膜炎的疗效对比研究
瞿佳	温州医学院附属眼视光医院	中华眼视光学与视觉科学杂志	翼状胬肉对角膜生物力学特性的影响
瞿小妹	复旦大学附属眼耳鼻喉科医院眼科	眼科	奥洛他定治疗儿童过敏性结膜炎合并瞬目频繁的疗效观察
瞿玲辉	解放军181医院眼科中心	眼外伤职业眼病杂志	光学治疗性角膜切削术治疗复发性翼状胬肉
矫红	北京中医药大学附属东直门医院眼科	中国中医眼科杂志	退赤止痒液治疗春季结膜炎
石一宁	陕西省人民医院眼科	中国实用眼科杂志	下泪小点息肉致长期泪溢二例
石一宁	西安市中心医院眼科	临床眼科杂志	角膜缘干细胞移植联合丝裂霉素C应用对抑制翼状胬肉复发的初步观察
石一宁	西安市中心医院眼科	临床眼科杂志	角膜缘干细胞移植加丝裂霉素C棉片浸放与新鲜羊膜移植治疗翼状胬肉的对比观察
石义明	中国山东省邹城市人民医院眼科	国际眼科杂志	大范围切除联合新鲜羊膜移植治疗复发性翼状胬肉
石尧	南京军区南京总医院眼科	中华实验眼科杂志	泡性眼炎的激光扫描共焦显微镜下表现
石彦杰	兰州军区兰州总医院眼科中心	中华眼科杂志	翼状胬肉切除联合结膜自体移植术中纤维蛋白胶应用的Meta分析
石斌	长春八一医院	眼外伤职业眼病杂志	原发性翼状胬肉手术时机临床观察
石晶	西藏军区总医院眼科	眼外伤职业眼病杂志	高原低气压环境相关特殊眼外伤的防治
石晶	西藏军区总医院眼科	眼外伤职业眼病杂志	长时间存留的前房角异物摘出一例
石润梅	河北省唐山职业技术学院眼科	临床眼科杂志	春季卡他性结膜炎78例临床分析
石淼	兰州军区乌鲁木齐总医院	中华实验眼科杂志	沙眼衣原体两种基因诊断方法的比较
石淼	兰州军区乌鲁木齐总医院眼科	中华实验眼科杂志	维汉民族中学生沙眼衣原体感染调查
石芊	海军总医院眼科	中华眼科杂志	以伪膜性结膜炎为首发表现的水痘一例
石英	复旦大学附属上海市公共卫生中心	眼外伤职业眼病杂志	羊膜移植或联合自体角膜缘移植治疗翼状胬肉
石英	上海市吴泾医院眼科	临床眼科杂志	自体角膜缘干细胞移植联合羊膜移植治疗复发性翼状胬肉
石英	上海市吴泾医院眼科	临床眼科杂志	羊膜移植重建眼表的随访报告
石蕊	陕西省人民医院眼科	国际眼科杂志	三种手术方式治疗翼状胬肉疗效比较
石蕊	中国辽宁省辽阳市第三人民医院眼科	国际眼科杂志	自体角膜缘干细胞移植术治疗原发性翼状胬肉94例
石蕊	陕西省人民医院眼科	中国实用眼科杂志	下泪小点息肉致长期泪溢二例
石蕊	陕西省人民医院眼科	国际眼科杂志	平阳霉素在翼状胬肉早期干预治疗中的应用
石静	兰州军区乌鲁木齐总医院眼科	中华实验眼科杂志	维汉民族中学生沙眼衣原体感染调查
石龙华	江苏省江阴市人民医院	眼科	翼状胬肉根部切除联合丝裂霉素C治疗的临床观察
祝伟	中国天津市大港油田总医院眼科	国际眼科杂志	翼状胬肉与角膜散光的关系
祝磊	河南省眼科研究所	中华实验眼科杂志	盐酸左氧氟沙星滴眼液治疗细菌性结膜炎及角膜炎随机双盲对照临床研究
祝莹	大连市第三人民医院眼科	中国实用眼科杂志	平阳霉素结膜下注射治疗复发性翼状胬肉疗效观察
禤中宁	南宁市红十字会医院眼科	眼外伤职业眼病杂志	羊膜移植治疗翼状胬肉
秦丽	山东省日照市人民医院眼科	临床眼科杂志	带环形巩膜瓣及角膜缘的全角膜板层移植术治疗蚕蚀性角膜溃疡
秦丽	山东省日照市人民医院眼科	中国眼耳鼻喉科杂志	带环形巩膜瓣全角膜板层移植术治疗角膜表面衰竭
秦伟	第三军医大学西南医院	中国实用眼科杂志	原发性结膜肿瘤728例临床病理分析
秦光勇	黄石爱尔眼科医院	国际眼科杂志	翼状胬肉上结膜反向移植联合羊膜移植治疗复发胬肉
秦力维	北京100048海军总医院海空勤体检中心眼科	中国中医眼科杂志	上泪小管炎误诊为角结膜炎1例
秦常軍	中國吉林省四平市中心醫院眼科	国际眼科杂志	自體眼表移植術治瘵翼狀胬肉
秦波	中南大学湘雅二医院眼科	中国实用眼科杂志	翼状胬肉的不同术式对创面上皮修复及复发率的影响
秦波	暨南大学医学院深圳眼科中心深圳市眼科医院	国际眼科杂志	翼状胬肉眼使用电脑验光和视网膜检影测定散光的对比研究
秦磊	暨南大学附属深圳市眼科医院角膜病科	国际眼科杂志	羊膜移植术治疗重症春季卡他性结膜炎的疗效分析
程丹富	山东省日照市人民医院眼科	临床眼科杂志	带环形巩膜瓣及角膜缘的全角膜板层移植术治疗蚕蚀性角膜溃疡
程丹富	山东省日照市人民医院眼科	中国眼耳鼻喉科杂志	带环形巩膜瓣全角膜板层移植术治疗角膜表面衰竭
程争平	南通大学附属医院眼科	中华眼视光学与视觉科学杂志	共焦显微镜对翼状胬肉及其周围角膜的组织病理学观察
程娟	重庆三峡中心医院眼科	国际眼科杂志	翼状胬肉切除联合丝裂霉素C及羊膜移植
程子昂	广西中医学院附属瑞康医院眼科	国际眼科杂志	角膜塑形镜治疗青少年近视的临床观察
程微	河南省信阳市中心医院眼科	眼外伤职业眼病杂志	由颈部逆向分离翼状胬肉切除术的探讨
程旭康	武汉市第一医院眼科	临床眼科杂志	翼状胬肉切除联合应用丝裂霉素 C 与自体结膜移植治疗翼状胬肉的 Meta 分析
程旭康	中国湖北省武汉市第一医院眼科	国际眼科杂志	Toric人工晶状体植入矫正特殊角膜散光的疗效观察
程旭康	中国湖北省武汉市第一医院眼科	国际眼科杂志	两种选择性环氧化酶-2抑制剂对翼状胬肉成纤维细胞生长影响的对比研究
程旭康	中国湖北省武汉市第一医院眼科	国际眼科杂志	丹参酮ⅡA对抑制翼状胬肉成纤维细胞增殖的研究
程旭康	中国湖北省武汉市第一医院眼科	国际眼科杂志	氩激光治疗翼状胬肉疗效分析
程时富	阆中市人民医院	眼外伤职业眼病杂志	结膜移植联合平阳霉素治疗复发性翼状胬肉
程杰	中国宁夏回族自治区银川市	国际眼科杂志	绿脓杆菌性角膜溃疡抢救成功1例
程海利	安徽省安庆市第一人民医院眼科	临床眼科杂志	生物羊膜联合自体角膜缘上皮干细胞移植在难治性翼状胬肉中的疗效研究
程海霞	南京医科大学附属南京儿童医院眼科	中国眼耳鼻喉科杂志	原发性翼状胬肉760例术后复发情况分析
程瑜	上海第二医科大学附属瑞金医院眼科	眼外伤职业眼病杂志	翼状胬肉术中丝裂霉素不同留置时间的效果
程美仙	福建医科大学附属漳州市医院眼科	国际眼科杂志	自体角膜缘干细胞移植术治疗复发性翼状胬肉疗效观察
程金伟	第二军医大学长征医院眼科	中国实用眼科杂志	自体角膜缘上皮移植治疗复发性翼状胬肉
程鹏	中国江苏省高邮市人民医院眼科	国际眼科杂志	自体结膜在翼状胬肉手术治疗中的美容效果观察
穆凤平	秦皇岛市第一医院	眼外伤职业眼病杂志	自体结膜角膜缘上皮移植治疗翼状胬肉临床观察
章剑	鄂州市中心医院眼科	眼外伤职业眼病杂志	翼状胬肉两种不同术式的临床观察
章复坤	中国陕西省商洛市中心医院眼科	国际眼科杂志	苏丹喀土穆地区春季卡他性角结膜炎720例临床分析
章政	鄂州市中心医院眼科	眼外伤职业眼病杂志	翼状胬肉两种不同术式的临床观察
章玲	青岛经济开发区第一人民医院眼科	国际眼科杂志	干眼症的临床分析
章青	南京市中医院眼科	临床眼科杂志	三种术式治疗翼状胬肉疗效观察
童亮	宁夏吴忠市人民医院眼科	临床眼科杂志	曲安缩松球结膜下注射治疗春季卡他性结膜炎
童奇湖	宁波市鄞州人民医院	中国实用眼科杂志	翼状胬肉不同术式效果观察
童峰峰	湖州师范学院附属第一医院眼科	国际眼科杂志	翼状胬肉术后角膜屈光状态稳定时间的临床观察
童峰峰	浙江省湖州市第一人民医院眼科研究所	中华实验眼科杂志	翼状胬肉术后巩膜融解分析
童晓维	上海市眼病防治中心	中国实用眼科杂志	翼状胬肉手术对改善角膜散光及曲率的临床研究
童毓华	衢州市人民医院眼科	眼外伤职业眼病杂志	翼状胬肉撕离联合角膜缘干细胞移植的研究
童翀	安徽省安庆市第一人民医院眼科	临床眼科杂志	生物羊膜联合自体角膜缘上皮干细胞移植在难治性翼状胬肉中的疗效研究
童翀	安徽省安庆市第一人民医院眼科	临床眼科杂志	自体角膜缘上皮移植术与单纯切除治疗翼状胬肉的对比分析
童颖	中國遼宁大連市第二人民醫院眼科	国际眼科杂志	自體角膜缘上皮移植聯合5一氟脲嘧啶治瘵翼狀胬肉的臨床觀察
符丽琴	复旦大学附属眼耳鼻喉科医院眼科	临床眼科杂志	羊膜移植联合眼表润滑剂及配镜治疗初发性翼性胬肉
符之瑄	上海中医药大学附属普陀医院眼科	国际眼科杂志	利用OCT观察流行性出血性结膜炎的临床研究
简天明	天津市眼科医院天津医科大学眼科临床学院眼眶病眼整形科	中国实用眼科杂志	重视眼科影像学检查提高临床诊断率
管一沁	昆明市第一人民医院	眼外伤职业眼病杂志	羊膜移植丝裂霉素治疗复发性翼状胬肉
管卫群	南通医学院第二附属医院眼科江苏南通	眼科	低温保存人羊膜移植在重建眼表结构中的临床应用
管卫群	南通医学院第二附属医院眼科	眼科	单层或多层羊膜移植治疗眼表疾病
管学刚	山东省临沂市河东区汤河光明眼科医院	眼外伤职业眼病杂志	丝裂霉素C在翼状胬肉切除术中的应用
管建花	上海交通大学附属上海市第六人民医院眼科	中华实验眼科杂志	翼状胬肉切除联合结膜转位及视原植入术治疗翼状胬肉的疗效观察
管建花	上海交通大学附属上海市第六人民医院眼科	临床眼科杂志	单纯结膜转位术与联合视原胶原植入术治疗翼状胬肉的疗效观察
管怀进	南通大学附属医院眼科江苏省医学重点学科	中华眼科杂志	我国防盲与眼科流行病学研究的现状及发展
管润农	山东省临沂市河东区汤河光明眼科医院	眼外伤职业眼病杂志	丝裂霉素C在翼状胬肉切除术中的应用
管润溪	山东省临沂市河东区汤河光明眼科医院	眼外伤职业眼病杂志	丝裂霉素C在翼状胬肉切除术中的应用
範健	中國貴州省黔西南州醫院眼科	国际眼科杂志	羊膜移植聯合絲裂霉素C治療翼狀胬肉
範貽明	中國河北省邢臺市眼科醫院跟科	国际眼科杂志	中西醫結合治瘵特异性幹眼癥
米尔沙力	中国新疆维吾尔自治区喀什地区第二人民医院眼科	国际眼科杂志	自体角膜缘干细胞移植治疗维吾尔族翼状胬肉的疗效
纪丽君	中国上海市徐汇区大华医院眼科	国际眼科杂志	改良逆行撕剥术联合自体结膜瓣移植治疗翼状胬肉的临床观察
缪和芬	上海市同济大学附属东方医院	中国眼耳鼻喉科杂志	翼状胬肉剪除术和传统切除术的临床比较
缪和芬	同济大学附属东方医院	中国眼耳鼻喉科杂志	翼状胬肉剪除术的临床疗效观察
罗丰年	中国人民解放军第161中心医院眼科	国际眼科杂志	角膜缘干细胞移植术治疗复发性翼状胬肉的疗效
罗丹	湖北省宜昌市中心人民医院眼视光学中心	国际眼科杂志	高频治疗仪治疗巨乳头性结膜炎的临床观察
罗丽娟	南昌大学研究生院医学部2005级	国际眼科杂志	翼状胬肉中MMP-2,TIMP-2和TGF-β1的表达意义
罗丽辉	中山大学中山眼科中心	中华眼科杂志	干眼患者115例的临床特点分析
罗乐平	湖南桃江县人民医院眼科	眼外伤职业眼病杂志	翼状胬肉手术中带状角膜缘组织移植及丝裂霉素C应用的意义
罗勤	上海和平眼科医院	中国实用眼科杂志	环孢素A在眼表移植和角膜炎症中的应用
罗婧	湖南博雅眼科医院	国际眼科杂志	生物羊膜联合带自体角膜缘干细胞的结膜瓣移植治疗伴睑球粘连的复发性翼状胬肉
罗家荣	黔南州人民医院	眼外伤职业眼病杂志	下方带蒂角膜缘上皮移植治疗翼状胬肉
罗平	广东省从化市人民医院	眼外伤职业眼病杂志	丝裂霉素C在翼状胬肉切除术中的应用
罗康怡	暨南大学医学院深圳眼科中心深圳市眼科医院	眼外伤职业眼病杂志	白内障合并翼状胬肉两种手术方案的选择
罗康怡	暨南大学附属深圳眼科医院	中国斜视与小儿眼科杂志	新生儿急性细菌性结膜炎病原菌及药物敏感性分析
罗建勋	安徽省安庆市第一人民医院眼科	临床眼科杂志	生物羊膜联合自体角膜缘上皮干细胞移植在难治性翼状胬肉中的疗效研究
罗建勋	安徽省安庆市第一人民医院眼科	临床眼科杂志	自体角膜缘上皮移植术与单纯切除治疗翼状胬肉的对比分析
罗恒	暨南大学附属深圳眼科医院	中国斜视与小儿眼科杂志	新生儿急性细菌性结膜炎病原菌及药物敏感性分析
罗恒	中国云南省南华县人民医院眼科	国际眼科杂志	自血治疗春季角结膜炎106例
罗旭昇	中国中医科学院眼科医院	中国中医眼科杂志	目痒证治1例
罗时运	首都医科大学附属北京同仁医院眼科中心	眼科	沙眼患者临床与实验室诊断研究
罗春云	广州医学院第二附属医院眼科	中国实用眼科杂志	螨脱敏治疗变应性结膜炎的观察
罗晓阳	广东省人民医院眼科	中华眼科杂志	移植物抗宿主病相关的干眼病
罗晓阳	广东省人民医院眼科	中华实验眼科杂志	造血干细胞移植术后的眼部观察
罗晨美	广东医学院微生物免疫学教研室	中国中医眼科杂志	高三尖杉酯碱和血栓通对人翼状胬肉成纤维细胞周期性变化的影响
罗曼	绍兴市人民医院	眼外伤职业眼病杂志	羊膜移植与角膜缘干细胞移植治疗翼状胬肉
罗添场	福建医科大学附属漳州市医院眼科	国际眼科杂志	自体角膜缘干细胞移植术治疗原发性翼状胬肉疗效观察
罗添场	漳州市医院眼科	眼科	自体结膜瓣转位移植治疗翼状胬肉
罗添场	福建医科大学附属漳州市医院眼科	国际眼科杂志	自体角膜缘干细胞移植术治疗复发性翼状胬肉疗效观察
罗燕生	河北省职工医学院附属医院眼科	眼科	部分切除并联合自体角膜上皮干细胞移植治疗翼状胬肉
罗秀菊	辽宁省本溪市中心医院眼科	中国眼耳鼻喉科杂志	羊膜移植治疗翼状胬肉的临床观察
罗翠平	平顶山煤业集团总医院眼科	中华实验眼科杂志	羊膜移植术在治疗大泡性角膜病变中的应用价值
罗肇文	大连医科大学附属第一临床学院	中国实用眼科杂志	自体角膜缘结膜移植治疗翼状胬肉
罗艳	中国湖北省武汉市第一医院眼科	国际眼科杂志	氩激光治疗翼状胬肉疗效分析
罗艳	中国湖北省武汉市第一医院眼科	国际眼科杂志	Toric人工晶状体植入矫正特殊角膜散光的疗效观察
罗远芳	深圳市龙岗中心医院眼科	眼外伤职业眼病杂志	翼状胬肉手术中羊膜移植与自体角膜缘干细胞移植的效果对比
羅恒	，中國雲南省南華縣人民醫院五官科	国际眼科杂志	用點必舒舆頭孢噻肟鈉治療新生兒淋菌性結膜炎4例
翁士春	浙江省泰顺县人民医院	中国实用眼科杂志	头孢曲松钠治疗新生儿淋菌性结膜炎
翁建宇	广东省人民医院血液科	中华眼科杂志	移植物抗宿主病相关的干眼病
翁建宇	广东省人民医院血液科	中华实验眼科杂志	造血干细胞移植术后的眼部观察
翁永德	中国人民解放军第四二一医院眼科	国际眼科杂志	术中应用丝裂霉素治疗不同类型原发性翼状胬肉的疗效观察
翁永德	中国人民解放军第四二一医院眼科	国际眼科杂志	生物羊膜移植联合丝裂霉素和血管抑素治疗复发性翼状胬肉
翟军印	解放军59中心医院眼科	临床眼科杂志	四头带加压致角膜后弹力层断裂2例
翟建设	河南省信阳市中心医院眼科	眼外伤职业眼病杂志	由颈部逆向分离翼状胬肉切除术的探讨
翟文娟	天津市眼科医院	临床眼科杂志	手术切除联合贝复舒治疗翼状胬肉的疗效观察
耿美香	解放军59中心医院眼科	临床眼科杂志	四头带加压致角膜后弹力层断裂2例
聂丹瑶	暨南大学附属深圳市眼科医院	中国实用眼科杂志	新生儿急性细菌性结膜炎10年致病菌变迁
聂丹瑶	中国广东省深圳市眼科医院角膜及眼表疾病科	国际眼科杂志	翼状胬肉术后不同处理方法对创面上皮修复的影响
聂丹瑶	深圳暨南大学附属深圳市眼科医院	中国斜视与小儿眼科杂志	新生儿淋菌性结膜炎致病菌10年药物敏感性的变迁
聂军	湖北省宜昌市夷陵医院眼科	中国眼耳鼻喉科杂志	氟康唑联合聚维酮碘治疗真菌性结膜炎
聂少文	湖北省老河口市第一医院眼科	眼外伤职业眼病杂志	羊膜移植治疗翼状胬肉的临床观察
聂爱光	中南大学湘雅第二医院眼科	中华眼科杂志	自体角膜缘上皮移植术治疗翼状胬肉的临床分析
聂玉红	中山大学中山眼科中心	国际眼科杂志	β-catenin在翼状胬肉成纤维细胞中的表达
肖伟	中国医科大学附属盛京医院眼科	国际眼科杂志	糖皮质激素眼液在流行性角结膜炎治疗中的应用
肖位保	福建医科大学2002级硕士研究生	眼科	Stevens-Johnson综合征研究现状
肖健	利川市民族中医院	眼外伤职业眼病杂志	翼状胬肉撕脱术治疗翼状胬肉
肖利华	北京武警总医院北京	眼科	后巩膜炎3例报告
肖启国	南华大学第二附属医院	中国中医眼科杂志	保存羊膜及丝裂霉素对翼状胬肉眼表的影响
肖启国	中山大学中山眼科中心	中国实用眼科杂志	新生儿急性细菌性结膜炎细菌培养结果分析
肖启国	中山大学中山眼科中心	中华眼科杂志	干眼患者115例的临床特点分析
肖启国	中山大学中山眼科中心	中国实用眼科杂志	翼状胬肉切除对泪液功能的影响
肖启国	南华大学第二附属医院眼科中心	中华眼科杂志	过敏性结膜炎的诊治
肖天林	温州医学院附属眼视光医院	中国实用眼科杂志	应用活体共焦显微镜观察翼状胬肉组织结构
肖学珊	中山大学中山眼科中心遗传分子生物学实验室	临床眼科杂志	PCR扩增技术在新生儿结膜炎中的诊断应用
肖志军	江西省遂川县人民医院	中国眼耳鼻喉科杂志	自体部分角膜缘移植治疗复发性翼状胬肉
肖志刚	湖南省儿童医院眼科	国际眼科杂志	婴幼儿泪囊炎的治疗综述
肖斯贤	汕头大学医学院第一附属医院眼科	临床眼科杂志	翼状胬肉术后滴用0.05g/L丝裂霉素C的疗效观察
肖春霞	中国甘肃省天水市秦州区眼科医院	国际眼科杂志	康宁克通A与丝裂霉素在单纯翼状胬肉切除术后应用观察
肖津安	中国陕西省西安市第四医院眼科	国际眼科杂志	医用生物蛋白胶在翼状胬肉切除联合角膜缘干细胞移植术中的应用
肖爱萍	江苏江阴市人民医院眼科	眼外伤职业眼病杂志	丝裂霉素C在翼状胬肉术中使用的疗效比较
肖琼	深圳市人民医院暨南大学医学院第二附属医院眼科	中国实用眼科杂志	新鲜羊膜移植治疗翼状胬肉的临床疗效
肖璇	武汉大学人民医院眼科	临床眼科杂志	春季卡他性结膜炎的药物治疗疗效观察
肖秀林	广西壮族自治区柳州市柳钢医院眼科	中国眼耳鼻喉科杂志	羊膜与角膜缘上皮移植治疗复发性翼状胬肉
肖立伟	福建省闽候县人民医院眼科	眼外伤职业眼病杂志	双裸式结膜桥联合局部注射曲安缩松治疗翼状胬肉
肖素华	浙江省立同德医院眼科	国际眼科杂志	左氧氟沙星治疗重症细菌性眼病的疗效及耐药性
肖耀廷	中国上海市长宁区中心医院眼科	国际眼科杂志	羊膜移植治疗复发性翼状胬肉32例
肖诗艺	深圳市儿童医院眼科	国际眼科杂志	FK506对实验性过敏性结膜炎细胞因子表达的影响
肖豪华	中国广东省梅县人民医院眼科	国际眼科杂志	羊膜移植联合保留球结膜翼状胬肉切除术的临床研究
肖颖	福州市第二医院病理科	中国实用眼科杂志	翼状胬肉的发生与角膜缘干细胞缺乏的病理研究
胡世兴	中山大学中山眼科中心中山大学眼科学国家重点实验室	国际眼科杂志	汉防己甲素抑制翼状胬肉成纤维细胞增殖的研究
胡世兴	中山大学中山眼科中心	中华实验眼科杂志	春季角膜结膜炎的免疫学发病机制研究
胡世兴	中山大学中山眼科中心中山大学眼科学国家重点实验室	国际眼科杂志	汉防己甲素对翼状胬肉成纤维细胞基质金属蛋白酶的影响
胡世兴	中国中医研究院眼科医院	中华实验眼科杂志	汉防己甲素对翼状胬肉成纤维细胞抑制作用的实验研究
胡世兴	中山大学中山眼科中心	中国实用眼科杂志	正常球结膜与翼状胬肉成纤维细胞生长增殖状况的对比观察
胡丹	天津医科大学眼科中心	国际眼科杂志	云南省怒江州贡山县翼状胬肉的流行病学调查
胡丽婷	青岛大学医学院附属医院眼科	国际眼科杂志	翼状胬肉患者手术前后泪膜功能的变化
胡义珍	华中科技大学附属协和医院	中华眼视光学与视觉科学杂志	儿童过敏性结膜炎与变应性疾病的相关性
胡义珍	华中科技大学同济医学院附属协和医院眼科	临床眼科杂志	儿童过敏性结膜炎和过敏性鼻炎的关系
胡义珍	华中科技大学同济医学院附属协和医院眼科	国际眼科杂志	儿童过敏性结膜炎诊治进展
胡亚丽	玉溪市第一人民医院眼科	中国中医眼科杂志	新生儿淋菌性结膜炎的疗效观察
胡全旭	河南省兰考县中医院眼科	眼外伤职业眼病杂志	冷冻治疗早期翼状胬肉的临床观察
胡劫	浙江省台州市中心医院眼科	临床眼科杂志	翼状胬肉手术治疗不同术式的比较
胡劫	台州市中心医院眼科	中国中医眼科杂志	翼状胬肉手术不同术式的比较
胡媛	中国医科大学附属盛京医院眼科	国际眼科杂志	蒲地蓝消炎口服液治疗流行性角结膜炎的临床疗效
胡学斌	中国湖北省宜昌市中心人民医院视光学专科	国际眼科杂志	LASIK手术与翼状胬肉相互影响的探讨
胡宏伟	江苏省通州市第三人民医院	临床眼科杂志	康宁克通-A球结膜下注射治疗春季卡他性结膜炎
胡建民	福建医科大学附属二院眼科	中国实用眼科杂志	系统性红斑狼疮患者眼表损害及相关抗体检测
胡建章	福建医科大学附属第一医院福建省眼科研究所	中国实用眼科杂志	翼状胬肉中细胞增殖与凋亡相关基因蛋白的表达及其意义
胡建章	福建医科大学第一附属医院	中华眼视光学与视觉科学杂志	基质金属蛋白酶-1及其抑制剂和转化生长因子-β1在翼状胬肉中的表达及意义
胡建章	福建医科大学附属第一医院眼科	眼科	自体角膜缘干细胞移植治疗翼状胬肉
胡志发	山东省高唐县人民医院眼科	眼外伤职业眼病杂志	角膜缘组织和球结膜伸展移植治疗翼状胬肉
胡敏	中国陕西省安康市中心医院眼科	国际眼科杂志	新鲜羊膜与生物羊膜移植治疗翼状胬肉的临床观察
胡文彦	青州眼科医院潍坊医学院卫生统计学教研室	中国实用眼科杂志	青州市农村≥60岁居民眼疾病状况及未就诊影响因素分析
胡文禹	浙江省舟山市普陀人民医院眼科	中国中医眼科杂志	翼状胬肉切除术后辅用中药的疗效观察
胡文静	中国陕西省延安市人民医院眼科	国际眼科杂志	复发性翼状胬肉逆行切除包埋加自体角膜缘干细胞移植术疗效观察
胡斌	河南省信阳市中心医院眼科	眼外伤职业眼病杂志	由颈部逆向分离翼状胬肉切除术的探讨
胡新文	江西省遂川县人民医院	中国眼耳鼻喉科杂志	自体部分角膜缘移植治疗复发性翼状胬肉
胡旭红	上海市金山区漕泾镇卫生院眼科	眼外伤职业眼病杂志	较高浓度丝裂霉素C在胬肉切除术中的应用
胡明	济南市第二人民医院	临床眼科杂志	角膜干细胞移植在翼状胬肉显微手术中的应用
胡明生	江西省新余市人民医院眼科	中国眼耳鼻喉科杂志	新鲜羊膜移植治疗睑球粘连的临床观察
胡明莲	广东省台山市人民医院眼科	临床眼科杂志	冷冻保存羊膜移植治疗眼表疾病疗效观察
胡晓耘	安徽省铜陵有色职工总医院眼科	临床眼科杂志	两种自体结膜移植在翼状胬肉手术中的疗效观察
胡晓蕾	第三军医大学西南医院药剂科	眼外伤职业眼病杂志	翼状胬肉两种不同术式临床疗效对比
胡楠	南通大学附属医院眼科	中华眼视光学与视觉科学杂志	共焦显微镜对翼状胬肉及其周围角膜的组织病理学观察
胡洋	解放军第171医院	眼外伤职业眼病杂志	羊膜移植治疗复发性翼状胬肉(附10例报告)
胡洋	解放军第一七一医院	眼外伤职业眼病杂志	丝裂霉素C在翼状胬肉手术中的应用
胡灯群	象山县第一人民医院	眼外伤职业眼病杂志	羊膜联合自体角膜缘干细胞移植治疗复发性翼状胬肉
胡燕华	华中科技大学同济医学院附属协和医院	中华眼视光学与视觉科学杂志	基质细胞衍生因子及其受体CXCR4在翼状胬肉的异常表达
胡燕华	华中科技大学同济医学院附属协和医院眼科	临床眼科杂志	春季角结膜炎角膜缘病变的手术治疗
胡燕华	华中科技大学附属协和医院眼科	国际眼科杂志	羊膜移植治疗春季角结膜炎的角膜缘病变
胡燕华	华中科技大学同济医学院附属协和医院眼科	中华实验眼科杂志	维生素E琥珀酸酯抑制人翼状胬肉成纤维细胞生长作用的研究
胡燕华	武汉市协和医院眼科	中华实验眼科杂志	翼状胬肉上皮细胞基质金属蛋白酶Ⅱ的表达
胡燕华	华中科技大学同济医学院附属协和医院眼科	中华眼科杂志	春季角结膜炎巨大乳头手术治疗的临床分析
胡玉红	新疆生产建设兵团总医院	眼外伤职业眼病杂志	巩膜表层血管烧灼联合推进式结膜移植治疗翼状胬肉
胡竹林	同济医科大学附属同济医院眼科	中华实验眼科杂志	自体角膜缘与结膜移植治疗复发性翼状胬肉
胡竹林	昆明医学院第四附属医院眼科	中华实验眼科杂志	睑缘切开带蒂轮匝肌瓣充填术治疗严重上睑内翻倒睫疗效观察
胡红莉	江苏省南京市中医院眼科	眼科	滴用盐酸奥布卡因引起一过性瞳孔散大三例
胡耀	武汉艾格眼科医院	国际眼科杂志	武汉城区及周边农村翼状胬肉患病率的流行病学调查
胡艳	山东省威海市立医院眼科	中国眼耳鼻喉科杂志	新生儿泪囊炎的按摩治疗法
胡茫	武汉市第一医院眼科	临床眼科杂志	翼状胬肉切除联合应用丝裂霉素 C 与自体结膜移植治疗翼状胬肉的 Meta 分析
胡莲娜	解放军306医院眼科	眼科	不含苯扎氯铵的抗青光眼滴眼液疗效及安全性的Meta分析
胡萍	上海交通大学附属上海市第六人民医院眼科	临床眼科杂志	单纯结膜转位术与联合视原胶原植入术治疗翼状胬肉的疗效观察
胡萍	上海交通大学附属上海市第六人民医院眼科	中华实验眼科杂志	翼状胬肉切除联合结膜转位及视原植入术治疗翼状胬肉的疗效观察
胡长涛	中国人民解放军第273医院眼科，库尔勒	中国中医眼科杂志	巴音郭楞蒙古自治州5县市翼状胬肉患病率的调查
胡青	湖北荆门市石化医院	眼外伤职业眼病杂志	5-氟尿嘧啶联合自体角膜缘组织移值治疗翼状胬肉
胡麒祎	中国上海复旦大学附属眼耳鼻喉科医院眼科	国际眼科杂志	翼状胬肉手术方法的改进
胡麒祎	复旦大学附属眼耳鼻喉科医院眼科	中国眼耳鼻喉科杂志	羊膜移植在结膜重建中的应用
胡麒祎	复旦大学附属眼耳鼻喉科医院眼科	中国眼耳鼻喉科杂志	翼状胬肉剪除术的临床疗效观察
胡麒褂	复旦大学附属眼耳鼻喉科医院眼科	临床眼科杂志	羊膜移植联合眼表润滑剂及配镜治疗初发性翼性胬肉
胥来军	中国宁夏回族自治区银川市	国际眼科杂志	小牛血去蛋白提取物眼用凝胶对复发性翼状胬肉术后角膜切口修复的疗效观察
脱缰	巢湖市脱氏眼科医院	眼外伤职业眼病杂志	角膜缘干细胞移植与丝裂霉素C治疗翼状胬肉
脱耀慈	巢湖市脱氏眼科医院	眼外伤职业眼病杂志	角膜缘干细胞移植与丝裂霉素C治疗翼状胬肉
臧亚芳	江苏省张家港市第一人民医院眼科	临床眼科杂志	乙醇分离法联合丝裂霉素C治疗翼状胬肉疗效观察
臧晓霞	河北省保定市第二医院眼科	中华实验眼科杂志	术中应用丝裂霉素C治疗翼状胬肉实验和临床研究
臧美荣	青岛经济开发区第一人民医院眼科	国际眼科杂志	干眼症的临床分析
芦山	安徽省安庆宜城医院眼科	临床眼科杂志	综合治疗翼状胬肉的临床观察
芦晓磊	湖北省十堰市太和医院眼科	中华眼科杂志	门诊重症沙眼患者的有关因素调查
苏云	沈阳市爱尔眼科医院	中国实用眼科杂志	放线菌性泪小管炎的诊断和治疗
苏墨霖	福建省漳州市芝山卫生院眼科	眼外伤职业眼病杂志	平阳霉素滴眼预防翼状胬肉术后复发的观察
苏定旺	广东省中山火炬开发区医院眼科	国际眼科杂志	不同手术方式对翼状胬肉患者泪液功能的影响
苏明	广西防城港市防城第一人民医院	临床眼科杂志	那素达治疗春季卡他性结膜炎疗效观察
苏晓铎	首都医科大学附属同仁眼科中心	眼科	翼状胬肉大小与角膜地形图的相关性研究
苏玉英	陕西省汉中市中心医院	眼外伤职业眼病杂志	自体角膜缘干细胞移植治疗翼状胬肉效果分析
苏静	大连医科大学附属第四临床学院眼科	中国实用眼科杂志	自体角膜缘结膜移植治疗翼状胬肉
苏颖丹	广东省佛山市禅城区中心医院眼科	中国眼耳鼻喉科杂志	翼状胬肉术后巩膜融解2例
苏鸣	河北省儿童医院眼科	中国实用眼科杂志	儿童睑缘耻阴虱感染一例
苟春风	甘肃省人民医院	眼外伤职业眼病杂志	表皮生长因子在翼状胬肉术后的应用观察
范先群	上海交通大学附属第九人民医院眼科	临床眼科杂志	改良角膜缘干细胞移植术治疗翼状胬肉的临床观察
范先群	上海交通大学医学院附属第九人民医院眼科上海交通大学医学院眼科视觉科学研究所	中华眼视光学与视觉科学杂志	上海市艾滋病初诊患者眼部并发症及致盲原因调查分析
范军华	解放军第180医院眼科中心	国际眼科杂志	角膜缘干细胞滑行移植法切除翼状胬肉
范军华	解放军第180医院眼科中心	国际眼科杂志	两种翼状胬肉切除手术的同体异眼比较
范军华	泉州市解放军第180医院眼科中心	中国实用眼科杂志	角膜缘干细胞移行遮盖法切除翼状胬肉
范小全	中国海南省三亚市425医院眼科	国际眼科杂志	角膜缘干细胞移植治疗复发性翼状胬肉的疗效观察
范小全	中国人民解放军425医院眼科	国际眼科杂志	三亚市郊≥50岁人群低视力及盲流行病学调查
范忠义	沈阳军区总医院眼科	中国实用眼科杂志	三重眼表解剖屏障重建术防治翼状胬肉复发四年前瞻性研究
范忠义	中国人民解放军第463医院眼科	国际眼科杂志	翼状胬肉扩大切除联合自体角膜缘干细胞移植术的临床疗效观察
范惠雅	中国广东省惠州市中心人民医院眼科	国际眼科杂志	翼状胬肉切除联合带自体角膜缘干细胞的结膜移植治疗复发性翼状胬肉
范敏	安徽省淮南市晨光眼科医院	临床眼科杂志	自体角膜缘干细胞移植联合准分子激光治疗性角膜切削术治疗翼状胬肉的临床观察
范春生	中国江苏省高邮市人民医院眼科	国际眼科杂志	自体结膜在翼状胬肉手术治疗中的美容效果观察
范杰	中国河北工程学院医学部附属医院化验室	国际眼科杂志	邯郸市区新生儿淋球菌性结膜炎发病的调查
范松涛	大连医科大学附属第一医院眼科	国际眼科杂志	球结膜瓣转移结合丝裂霉素C治疗翼状胬肉
范泰昌	中国辽宁省瓦房店市中心医院眼科	国际眼科杂志	两种术式治疗原发性翼状胬肉的疗效比较
范瑞	沈阳爱尔眼视光医院	中国实用眼科杂志	泪腺导管囊肿一例
范瑞	沈阳爱尔眼视光医院	中国实用眼科杂志	外眦角泪腺排泄管异物二例
范瑞	沈阳市爱尔眼视光医院	中国实用眼科杂志	自体角膜缘干细胞移植联合丝裂霉素C治疗翼状胬肉疗效观察
范瑞	沈阳市爱尔眼科医院	中国实用眼科杂志	放线菌性泪小管炎的诊断和治疗
范艳华	湖南中医药大学第一附属医院眼科	中国中医眼科杂志	眼科围手术期的中医药治疗
范雯	武汉大学人民医院眼科	中华实验眼科杂志	翼状胬肉切除联合自体球结膜移植术中使用纤维蛋白胶和缝线有效性的随机对照试验的Meta分析
茅晓红	江苏省海门市中医院	中华眼视光学与视觉科学杂志	共焦显微镜对翼状胬肉及其周围角膜的组织病理学观察
茶国铭	云南省巍山县人民医院眼科	眼外伤职业眼病杂志	干扰素联合结膜移植预防翼状胬肉术后复发
茶国铭	巍山县医院眼科	眼科	微波热凝预防翼状胬肉术后复发
茹克亚	伊犁哈萨克自治州中医医院中西医眼病中心	中国中医眼科杂志	自体角膜缘干细胞结膜移植治疗翼状胬肉
荣卫平	湖南省永州市人民医院	中国实用眼科杂志	保存羊膜与新鲜羊膜治疗眼表疾病的比较研究
荣得彦	广西柳州市眼科医院	临床眼科杂志	中低温保存羊膜在复杂眼表疾病中的应用
荣瑜	安徽省安庆市第一人民医院眼科	临床眼科杂志	生物羊膜联合自体角膜缘上皮干细胞移植在难治性翼状胬肉中的疗效研究
荣瑜	安徽省安庆市第一人民医院眼科	临床眼科杂志	自体角膜缘上皮移植术与单纯切除治疗翼状胬肉的对比分析
荣翱	同济大学附属同济医院眼科	眼外伤职业眼病杂志	前段光学相干断层成像测量翼状胬肉术后结膜植片厚度的临床研究
荣蓓	北京大学第一医院眼科	中华眼科杂志	眼瘢痕性类天疱疮病例的回顾性分析
莫利娟	上海中医药大学附属普陀医院眼科	国际眼科杂志	利用OCT观察流行性出血性结膜炎的临床研究
莫劲松	深圳市眼科医院	中国中医眼科杂志	化胬抑复冲剂降低翼状胬肉术后复发率的临床研究
莫小勤	广西百色地区人民医院	眼外伤职业眼病杂志	自身角膜缘结膜移植治疗翼状胬肉
莫百军	广东医学院附属医院眼科	中华实验眼科杂志	丝裂霉素C抗人翼状胬肉成纤维细胞增殖的实验研究
莫百军	浙江省嘉兴市第一医院	中华眼视光学与视觉科学杂志	蝮蛇抗栓酶对人翼状胬肉成纤维细胞增殖效果的影响
莫百军	浙江省嘉兴市第一医院眼科	中华实验眼科杂志	PCNA和bcl-2在翼状胬肉成纤维细胞中的表达及蝮蛇抗栓酶的影响
莫阿力木	新疆喀什地区卫生学校五官科教研室	国际眼科杂志	自体角膜缘干细胞移植治疗维吾尔族翼状胬肉的疗效
葛建杰	山东省威海市文登中心医院眼科	中国眼耳鼻喉科杂志	文登沿海乡镇中老年翼状胬肉的流行病学特点
葛琳	安徽省马鞍山市马钢医院眼科	临床眼科杂志	羊膜移植治疗翼状胬肉临床疗效观察
葛红霞	中国陕西省咸阳市第一人民医院眼二科	国际眼科杂志	自体角膜缘干细胞移植联合丝裂霉素治疗翼状胬肉的临床效果
葛红霞	陕西省咸阳市第一人民医院眼科	中国实用眼科杂志	自体角膜缘干细胞移植联合丝裂霉素治疗复发性翼状胬肉33例分析
葛胜利	延安大学附属医院眼科	国际眼科杂志	复发性翼状胬肉切除联合自体角膜缘上皮移植的疗效分析
葛钧	深圳市人民医院暨南大学医学院第二附属医院眼科	中国实用眼科杂志	新鲜羊膜移植治疗翼状胬肉的临床疗效
葛钧	深圳市人民医院暨南大学医学院二附院	眼科	新鲜羊膜移植治疗眼化学伤和翼状胬肉
葛静	安徽省蒙城县第二人民医院	临床眼科杂志	翼状胬肉切除联合自体角膜缘干细胞移植手术的临床观察
葛飞凤	福建省三明市第一医院遗传研究室	中华实验眼科杂志	睑结膜部炎症者肺炎衣原体、沙眼衣原体核酸检测
董万江	绵阳万江眼科医院眼科	国际眼科杂志	带蒂结膜瓣移植联合MMC治疗翼状胬肉合并结膜松弛症
董万江	绵阳万江眼科医院	眼外伤职业眼病杂志	羊膜移植治疗翼状胬肉137例
董业平	山东滕州市中心人民医院眼科	中国眼耳鼻喉科杂志	钝性分离胬肉联合自体角膜缘移植治疗翼状胬肉
董丽珍	北京市中关村医院眼科	眼科	90Srβ射线照射预防翼状胬肉术后复发追踪观察
董光明	中国核工业四○四医院眼科	中国眼耳鼻喉科杂志	自体角膜缘干细胞移植治疗翼状胬肉的临床疗效
董光美	张家口第四医院	中国实用眼科杂志	翼状胬肉切除术致迟发型眼-胃肠反射一例
董刚	中国湖北省大冶市人民医院眼科	国际眼科杂志	翼状胬肉切除联合角膜干细胞移植术中两种缝合方法对比研究
董卫红	济南施尔明眼科医院	眼外伤职业眼病杂志	自体角膜缘干细胞移植术治疗翼状胬肉
董平	江苏省人民医院眼科	临床眼科杂志	三种术式治疗翼状胬肉疗效观察
董应丽	河南省眼科研究所	中华实验眼科杂志	早产儿眼病的特征分析
董方田	中国协和医科大学	中华眼科杂志	人工眼的研究现状及发展前景
董方田	中国协和医科大学	中国实用眼科杂志	倒睫激光疗效106例观察
董晓云	中国人民解放军第474医院眼科医院	国际眼科杂志	头孢曲松钠治疗新生儿淋球菌性结膜炎
董永孝	中国陕西省咸阳市第一人民医院眼二科	国际眼科杂志	自体角膜缘干细胞移植联合丝裂霉素治疗翼状胬肉的临床效果
董永孝	陕西省咸阳市第一人民医院眼科	中国实用眼科杂志	自体角膜缘干细胞移植联合丝裂霉素治疗复发性翼状胬肉33例分析
董永章	，中國新疆獨山子石化總廠醫院眼科	国际眼科杂志	自體角膜緣幹細胞球結膜移植治療翼狀胬肉
董永章	中國新疆獨山子石化總廠醫院眼科	国际眼科杂志	翼狀胬肉切除結膜瓣轉移聯合β射綫照射72眼
董洁玉	三峡大学第一临床医学院湖北省宜昌市中心人民医院眼科	国际眼科杂志	改良式角膜缘干细胞移植治疗原发性翼状胬肉的手术体会
董玉忠	河南省安阳市眼科医院	中华实验眼科杂志	白内障术后患者免疫学检测
董翠兰	湖南省儿童医院眼科	国际眼科杂志	婴幼儿泪囊炎的治疗综述
董诺	厦门大学附属厦门眼科中心	中华眼科杂志	睑板腺形态学的研究进展
董诺	厦门大学附属厦门眼科中心	国际眼科杂志	翼状胬肉组织Caveolin-1,E-cadherin和P63的表达
董诺	厦门大学附属眼科中心厦门大学眼科研究所	中华眼科杂志	翼状胬肉上皮鳞状化生与泪膜稳定性的研究
董雪原	张家口市第四医院眼科	眼科	带蒂结膜瓣转移法治疗翼状胬肉疗效观察
董	河南省眼科研究所郑州	中华实验眼科杂志	羊膜移植术在治疗大泡性角膜病变中的应用价值
蒋丽	华中科技大学同济医学院附属协和医院眼科	国际眼科杂志	粉防己碱对翼状胬肉成纤维细胞增生作用的研究
蒋丽	华中科技大学同济医学院附属协和医院眼科	国际眼科杂志	NF -κB抑制剂吡咯烷二硫氨基甲酸对人翼状胬肉成纤维细胞增殖的影响
蒋冬红	江苏省泰兴市第二人民医院眼科	中国眼耳鼻喉科杂志	自体结膜移植治疗翼状胬肉
蒋凌	武钢第二职工医院眼科	眼外伤职业眼病杂志	5-氟尿嘧啶及丝裂霉素C在翼状胬肉术中的应用
蒋峰	第二军医大学长征医院眼科	国际眼科杂志	HTLV-1感染者的眼部临床表现
蒋慧	绵阳万江眼科医院	国际眼科杂志	中药内外合治治疗流行性出血性结膜炎疗效观察
蒋文化	湖南省永州市人民医院	中国实用眼科杂志	保存羊膜与新鲜羊膜治疗眼表疾病的比较研究
蒋毅萍	辽宁省丹东市第一医院眼科	中国实用眼科杂志	减少翼状胬肉复发的三种术式疗效比较
蒋燕玲	连云港市第二人民医院眼科	眼外伤职业眼病杂志	海水盐场职工翼状胬肉患病率分析及手术治疗的临床观察
蒋燕玲	中国江苏省连云港市第二人民医院眼科	国际眼科杂志	逆行切除联合自体角膜缘干细胞移植治疗翼状胬肉68例
蒋爱玲	南阳市眼科医院	眼外伤职业眼病杂志	翼状胬肉结膜移植联合塞替哌双氯酚酸钠观察
蒋玲月	湖南省永州市人民医院	中国实用眼科杂志	保存羊膜与新鲜羊膜治疗眼表疾病的比较研究
蒋秀彩	天津长征医院	中国中医眼科杂志	眼酒糟鼻57例临床观察
蒋秀彩	天津长征医院皮肤科	中国中医眼科杂志	睑角结膜炎病例临床表现及疗效分析
蒋自强	湘潭市中心医院眼科	眼外伤职业眼病杂志	眼轮匝肌灼烙治疗痉挛性睑内翻合并结膜松弛
蒋莉	辽宁省本溪市中心医院眼科	中国眼耳鼻喉科杂志	羊膜移植治疗翼状胬肉的临床观察
蒋蓉芳	常德爱尔眼科医院	中国实用眼科杂志	翼状胬肉术后角膜鳞状上皮癌一例
蒋运增	桂东人民医院眼科	眼外伤职业眼病杂志	羊膜移植联合丝裂霉素C治疗复发性翼状胬肉
蒲晓莉	陕西省咸阳市第一人民医院眼科	中国实用眼科杂志	自体角膜缘干细胞移植联合丝裂霉素治疗复发性翼状胬肉33例分析
蓝伟珠	浙江省泰顺县人民医院	中国实用眼科杂志	头孢曲松钠治疗新生儿淋菌性结膜炎
蓝平	沈阳军区总医院眼科	中国实用眼科杂志	三重眼表解剖屏障重建术防治翼状胬肉复发四年前瞻性研究
蓝育青	中山大学附属第二医院眼科	中国实用眼科杂志	姜黄素在眼科应用的研究和进展
蔡光辉	广东省惠东县人民医院眼科	临床眼科杂志	三种不同术式翼状胬肉切除术的临床对比观察
蔡剑秋	温州医学院附属第二医院眼科	临床眼科杂志	翼状胬肉术后的角膜地形图改变
蔡卫华	浙江慈溪市庵东中心医院眼科	中国中医眼科杂志	角膜缘干细胞移植治疗复发性翼状胬肉
蔡季平	第二军医大学附属长征医院眼科	临床眼科杂志	结膜瓣转移与羊膜移植治疗复发性翼状胬肉的疗效对比分析
蔡季平	第二军医大学长征医院眼科	国际眼科杂志	HTLV-1感染者的眼部临床表现
蔡宛亭	济南施尔明眼科医院	眼外伤职业眼病杂志	自体角膜缘干细胞移植术治疗翼状胬肉
蔡小军	武汉大学中南医院眼科	中国实用眼科杂志	复发翼状胬肉显微切除联合羊膜及自体角膜缘移植临床分析
蔡小军	武汉大学中南医院眼科	国际眼科杂志	综合治疗复发性翼状胬肉疗效观察
蔡小军	武汉大学中南医院眼科	国际眼科杂志	羊膜移植联合丝裂霉素C治疗翼状胬肉的Meta分析
蔡小芳	暨南大学化学系	中华实验眼科杂志	丝裂霉素C对翼状胬肉成纤维细胞膜通透性及超微结构的影响
蔡康荣	广东医学院微生物免疫学教研室	中国中医眼科杂志	高三尖杉酯碱和血栓通对人翼状胬肉成纤维细胞周期性变化的影响
蔡康荣	广东医学院	中华眼视光学与视觉科学杂志	蝮蛇抗栓酶对人翼状胬肉成纤维细胞增殖效果的影响
蔡新立	北京市中关村医院眼科	眼科	90Srβ射线照射预防翼状胬肉术后复发追踪观察
蔡明高	武汉大学人民医院眼科武汉大学医学院眼科研究所	中国实用眼科杂志	异体巩膜联合多层羊膜移植治疗翼状胬肉术后无菌性角巩膜融解的疗效探讨
蔡春梅	解放军第二炮兵总医院	眼科	自体角膜缘干细胞移植与羊膜移植治疗翼状胬肉的对比研究
蔡海英	上海市杨浦区中心医院眼科	中华实验眼科杂志	翼状胬肉三种不同术式的疗效分析
蔡涛	广西桂林市人民医院眼科	中国眼耳鼻喉科杂志	重组人表皮生长因子滴眼液对翼状胬肉术后角膜上皮愈合的影响
蔡玉环	平舆县第二人民医院	眼外伤职业眼病杂志	改良翼状胬肉切除联合角膜缘干细胞移植术
蔡玉莲	龙岗区坪山人民医院眼科	国际眼科杂志	生物羊膜联合带自体角膜缘干细胞的结膜瓣移植治疗伴睑球粘连的复发性翼状胬肉
蔡瑞云	湖南省人民医院细菌室	中国中医眼科杂志	白内障术前清洁结膜囊方法的比较
蔡素贞	河北医科大学第二医院眼科	中国实用眼科杂志	肺癌多脏器转移首诊眼科1例
蔡继林	湖南省岳阳市三人民医院眼科	中国眼耳鼻喉科杂志	翼状胬肉逆行切除联合自体结膜或角膜缘干细胞移植术的疗效观察
蔡鑫	南通大学附属海安医院眼科	眼外伤职业眼病杂志	复明工程中白内障合并翼状胬肉联合手术
蔡鸿英	天津市眼科医院	中华实验眼科杂志	青光眼术后巨大结膜囊肿一例
蔺林	复旦大学附属眼耳鼻喉科医院耳鼻喉科	中国眼耳鼻喉科杂志	不同螨致敏原对变应性鼻炎患者生活质量的影响
蔺波	兰州军区兰州总医院眼科中心	中华眼科杂志	翼状胬肉切除联合结膜自体移植术中纤维蛋白胶应用的Meta分析
薄玉霞	武城县中医院	眼外伤职业眼病杂志	复发性翼状胬肉的综合治疗及临床观察
薛兆武	山东省枣庄矿业集团中心医院眼科	临床眼科杂志	改良睑缘后退术治疗沙眼性上睑内翻倒睫疗效观察
薛小平	西北工业大学生命科学院	中华实验眼科杂志	抗腺病毒3型单克隆抗体的制备及临床应用研究
薛尚才	甘肃省第二人民医院眼科	临床眼科杂志	角膜缘血管切断术联合丝裂霉素治疗角膜新生血管效果观察
薛文文	上海交通大学附属第一人民医院眼科	国际眼科杂志	影响上海市外来务工子弟小学学生沙眼患病相关因素的调查研究
薛春燕	南京军区南京总医院眼科	中华实验眼科杂志	泡性眼炎的激光扫描共焦显微镜下表现
薛春燕	南京大学医学院临床学院南京军区南京总医院眼科	中华实验眼科杂志	激光共焦显微镜与组织病理学对翼状胬肉组织中微血管密度研究的比较
薛雨顺	陕西省人民医院眼科	国际眼科杂志	三种手术方式治疗翼状胬肉疗效比较
薛雨顺	陕西省人民医院眼科	国际眼科杂志	平阳霉素在翼状胬肉早期干预治疗中的应用
虞林丽	广东省佛山市第一人民医院眼科	临床眼科杂志	急性结膜炎痊愈后泪膜功能的变化
虞雁鸿	江苏省海门市人民医院眼科	临床眼科杂志	手术显微镜下大范围切除联合羊膜移植治疗复发性翼状胬肉
袁一飞	复旦大学附属眼耳鼻喉科医院	中华眼视光学与视觉科学杂志	还原型谷胱甘肽滴眼液促进翼状胬肉术后角膜上皮修复
袁中芳	山东省济南市中心医院眼科	临床眼科杂志	两种方法保存羊膜联合自体角膜缘移植治疗复发性翼状胬肉
袁中芳	山东省济南市中心医院眼科	中国实用眼科杂志	翼状胬肉切除联合羊膜移植术临床应用
袁久民	山东省新泰市人民医院眼科	中国眼耳鼻喉科杂志	显微镜下游离结膜移植术治疗翼状胬肉
袁佳琴	天津医科大学眼科中心	中国实用眼科杂志	表层巩膜炎合并复发性多发软骨炎1例
袁军	郑州市第二人民医院眼科	眼外伤职业眼病杂志	翼状胬肉手术中无缝线自体角膜缘干细胞移植
袁军	郑州市第二人民医院	中国实用眼科杂志	丝状角膜炎的临床治疗观察
袁启贤	广州市白云区红十字医院	中华实验眼科杂志	翼状胬肉术后角膜穿孔二例
袁启贤	广州市白云区红十字会医院五官科	临床眼科杂志	翼状胬肉术后角膜穿孔2例
袁媛	武汉艾格眼科医院	国际眼科杂志	武汉城区及周边农村翼状胬肉患病率的流行病学调查
袁平	安徽省安庆市第二人民医院眼科	临床眼科杂志	翼状胬肉切除联合自体角膜缘结膜移植术疗效分析
袁志兰	南京医科大学第一附属医院眼科	临床眼科杂志	羊膜移植在眼表疾病中的应用观察
袁志兰	南京医科大学第一附属医院眼科	中华眼科杂志	加替沙星和左氧氟沙星治疗细菌性结膜炎的疗效对比研究
袁志兰	江苏省人民医院眼科	临床眼科杂志	两种手术治疗翼状胬肉的临床观察
袁志刚	山西省眼科医院病理科	中国实用眼科杂志	翼状胬肉中Ki-67和VEGF的表达
袁敏	广东省东莞市樟木头医院眼科	临床眼科杂志	应用角膜缘移植治疗复发性翼状胬肉疗效分析
袁文晓	荣成市第二人民医院	眼外伤职业眼病杂志	鱼舱内鳀鱼腐败气体中毒的眼部表现
袁春秀	云南省大理州医院眼科	眼外伤职业眼病杂志	羊膜移植术治疗翼状胬肉临床分析
袁昱	陕西省汉中市中心医院	眼外伤职业眼病杂志	自体角膜缘干细胞移植治疗翼状胬肉效果分析
袁海燕	冠县人民医院	眼外伤职业眼病杂志	自体角膜缘干细胞移植治疗翼状胬肉临床观察
袁秀英	东莞市人民医院眼科	中华实验眼科杂志	干扰素a-2b与丝裂霉素C用于复发性胬肉的临床对比研究
袁红宜	广西南宁市第一人民医院眼科	眼外伤职业眼病杂志	自体结膜角膜缘上皮移植术及保存人羊膜移植术治疗翼状胬肉疗效分析
袁红宜	广西南宁市第一人民医院	眼外伤职业眼病杂志	保存人羊膜在眼表疾病中的应用
袁翊	解放军第117医院眼科	眼外伤职业眼病杂志	颅底骨折右眼眶骨折并颈动脉海绵窦瘘一例
袁苑	湖南博雅眼科医院	国际眼科杂志	绷带式角膜接触镜在翼状胬肉切除合并结膜移植术的应用
袁进	中山大学中山眼科中心	眼科	过敏性结膜炎的流行病学及奥洛他定滴眼液开放性多中心治疗的初步效果
袁铸	武汉科技大学附属天佑医院眼科	国际眼科杂志	翼状胬肉切除联合自体角膜缘干细胞移植与联合羊膜移植的疗效比较
袁铸	武汉科技大学附属天佑医院	眼外伤职业眼病杂志	风湿病患者双眼翼状胬肉术后发生坏死性巩膜炎
袁静	武汉大学人民医院眼科武汉大学医学院眼科研究所	中国实用眼科杂志	异体巩膜联合多层羊膜移植治疗翼状胬肉术后无菌性角巩膜融解的疗效探讨
袁静	武汉市协和医院眼科	中华实验眼科杂志	翼状胬肉上皮细胞基质金属蛋白酶Ⅱ的表达
袁静	华中科技大学同济医学院附属协和医院眼科	中华实验眼科杂志	维生素E琥珀酸酯抑制人翼状胬肉成纤维细胞生长作用的研究
袁静	中山大学中山眼科中心中山大学干细胞中心	国际眼科杂志	维生素E琥珀酸酯抑制人翼状胬肉成纤维细胞生长作用的研究
裘海燕	山东省滕州市中心医院眼科	临床眼科杂志	急性结膜囊肿1例
裴世林	中国河南省固始县人民医院眼科	国际眼科杂志	巩膜桥加压掩盖法治疗复发性翼状胬肉22例
裴国宾	镇平县人民医院	眼外伤职业眼病杂志	平阳霉素治疗翼状胬肉的疗效观察
裴志娟	淮南新华医院集团新华医院眼科	临床眼科杂志	淮南市煤矿工人翼状胬肉患病率的流行病学调查
裴重刚	南昌大学第一附属医院眼科	中国眼耳鼻喉科杂志	丝裂霉素C在眼科应用进展
褚仁远	复旦大学附属眼耳鼻喉科医院眼科	眼科	奥洛他定治疗儿童过敏性结膜炎合并瞬目频繁的疗效观察
褚仁远	复旦大学附属眼耳鼻喉科医院眼科	中国眼耳鼻喉科杂志	试题与答案
覃光海	三峡大学医学院附属医院，湖北宜昌	眼科	羊膜移植治疗大泡性角膜病变的临床应用
覃冬菊	复旦大学附属华山医院南汇分院眼科	国际眼科杂志	翼状胬肉切除改良术式的临床观察
覃冬菊	复旦大学附属华山医院南汇分院眼科	国际眼科杂志	翼状胬肉切除联合球结膜下生物羊膜移植的初步研究
覃启才	广西百色地区人民医院	眼外伤职业眼病杂志	自身角膜缘结膜移植治疗翼状胬肉
覃旭方	中山市小榄人民医院眼科	中国中医眼科杂志	自体角膜缘干细胞移植联合丝裂霉素C治疗翼状胬肉的临床研究
覃旭方	广东省中山市小榄人民医院眼科	眼外伤职业眼病杂志	新鲜及保存羊膜移植治疗翼状胬肉
解秀燕	海军青岛401医院眼科	眼外伤职业眼病杂志	不同部位角膜干细胞移植治疗翼状胬肉的疗效分析
解聪	辽宁抚顺眼病医院	中国实用眼科杂志	冻干人羊膜治疗翼状胬肉的临床观察
許美玲	中國天津市渤海石油公司職工醫院眼科，	国际眼科杂志	帶蒂球結膜與角膜緣上皮移植治療翼狀胬肉
詹天顺	重庆市第三人民医院眼科	眼外伤职业眼病杂志	翼状胬肉两种不同术式临床疗效对比
詹美英	浙江省淳安县第二人民医院眼科	眼外伤职业眼病杂志	丝裂霉素C预防翼状胬肉复发的临床观察
计江东	南京市玄武医院眼科	临床眼科杂志	自体结膜角膜缘移植与自体结膜移植治疗复发性翼状胬肉
许丹丹	中国人民解放军第421医院眼科	国际眼科杂志	顺逆行切除术联合丝裂霉素治疗翼状胬肉的疗效
许乐梅	寿光市人民医院	眼科	Behcet病角膜溃疡穿孔误诊一例
许伟	伊犁哈萨克自治州中医医院中西医眼病中心	中国中医眼科杂志	自体角膜缘干细胞结膜移植治疗翼状胬肉
许国忠	浙江省中西医结合医院眼科	国际眼科杂志	翼状胬肉术中应用bevacizumab与丝裂霉素C的比较
许大玲	三峡大学第一临床医学院湖北省宜昌市中心人民医院眼科	国际眼科杂志	改良式角膜缘干细胞移植治疗原发性翼状胬肉的手术体会
许娜	重庆医科大学附属第一医院眼科	国际眼科杂志	基质金属蛋白酶及其组织抑制剂与白内障
许宇	上海交通大学医学院附属新华医院眼科	中华眼底病杂志	经双目间接检眼镜激光光凝治疗严重早产儿视网膜病变
许宇东	中国上海市第八人民医院眼科	国际眼科杂志	配戴隐形眼镜后发生伪膜性结膜炎1例
许家骏	北京中医药大学东直门医院眼科	中国中医眼科杂志	自体结膜角膜缘干细胞移植术治疗翼状胬肉的临床观察
许家骏	北京中医药大学附属东直门医院眼科	中国中医眼科杂志	退赤止痒液治疗春季结膜炎
许寿芬	云南省大理白族自治州人民医院眼科	临床眼科杂志	翼状胬肉与角膜散光的关系初步报告
许寿芬	云南省大理州人民医院眼科	眼外伤职业眼病杂志	眼外伤及眼表疾病自体角膜缘干细胞移植术
许建芳	中国湖南省郴州市第一人民医院眼科	国际眼科杂志	羊膜移植与结膜瓣转移治疗复发性翼状胬肉的疗效比较
许振国	福建省三明市第三医院眼科	中国实用眼科杂志	丝裂霉素C溶液滴眼致巩膜坏死的救治
许时	南京市玄武医院眼科	临床眼科杂志	自体结膜角膜缘移植与自体结膜移植治疗复发性翼状胬肉
许明林	中国医科大学附属第四医院眼科	中国实用眼科杂志	翼状胬肉切除加相邻带干细胞自体结膜转位术疗效观察
许明林	中国医科大学附属第四医院眼科	国际眼科杂志	两种不同术式治疗翼状胬肉的疗效比较
许海嘉	成都市第一人民医院	中国实用眼科杂志	软性角膜接触镜致巨乳头性结膜炎的治疗
许海嘉	中国四川省成都市第一人民医院眼科	国际眼科杂志	翼状胬肉切除联合角膜缘干细胞移植及术后药物治疗临床观察
许淑云	中国陕西省咸阳市第一人民医院眼二科	国际眼科杂志	自体角膜缘干细胞移植联合丝裂霉素治疗翼状胬肉的临床效果
许淑云	陕西省咸阳市第一人民医院眼科	中国实用眼科杂志	自体角膜缘干细胞移植联合丝裂霉素治疗复发性翼状胬肉33例分析
许玮琳	中国河南省扶沟县人民医院眼科	国际眼科杂志	自体角膜缘干细胞联合羊膜移植治疗眼表疾病
许玲	郧阳医学院附属太和医院眼科	国际眼科杂志	增殖细胞核抗原和胰岛素样生长因子Ⅱ在翼状胬肉组织中的表达
许玲	湖北医药学院附属太和医院眼科	临床眼科杂志	翼状胬肉手术前后对比敏感度和角膜地形图改变的比较
许玲	湖北医药学院附属太和医院眼科	临床眼科杂志	初发性翼状胬肉术中单用利多卡因凝胶与丁卡因滴液表面麻醉效果对比分析
许琦彬	浙江省中西医结合医院眼科	国际眼科杂志	翼状胬肉术中应用bevacizumab与丝裂霉素C的比较
许素珍	祁门县灯塔眼科医院	眼外伤职业眼病杂志	不同术式治疗翼状胬肉临床观察
许美玲	渤海石油职工医院眼科	国际眼科杂志	应用雾化疗法治疗流行性出血性角结膜炎临床观察
许美玲	天津市渤海石油医院眼科	眼外伤职业眼病杂志	带蒂球结膜与角膜缘上皮移植治疗翼状胬肉
许美玲	海洋石油总医院眼科	国际眼科杂志	两种翼状胬肉术式对不同人群的影响
许美玲	中国海洋石油总医院眼科	国际眼科杂志	老年性上睑皮肤松垂及睑内翻矫正术
许艳红	无锡惠山区人民医院眼科	国际眼科杂志	翼状胬肉切除联合带蒂结膜瓣移植术
许蒲华	长垣县人民医院	眼外伤职业眼病杂志	羊膜移植治疗翼状胬肉的临床疗效
许迅	上海交通大学附属市第一人民医院眼科	中国眼耳鼻喉科杂志	羊膜移植在结膜重建中的应用
许运新	博白县人民医院	眼外伤职业眼病杂志	自体角膜缘上皮移植治疗翼状胬肉
许颖仪	广东省台山市人民医院眼科	临床眼科杂志	冷冻保存羊膜移植治疗眼表疾病疗效观察
诸凤娇	深圳暨南大学附属深圳市眼科医院	中国斜视与小儿眼科杂志	新生儿淋菌性结膜炎致病菌10年药物敏感性的变迁
诸凤娇	暨南大学附属深圳市眼科医院	中国实用眼科杂志	新生儿急性细菌性结膜炎10年致病菌变迁
诸力伟	浙江省中西医结合医院眼科	国际眼科杂志	翼状胬肉术中应用bevacizumab与丝裂霉素C的比较
谈刚	绵阳万江眼科医院眼科	国际眼科杂志	带蒂结膜瓣移植联合MMC治疗翼状胬肉合并结膜松弛症
谢云萍	云南省文山州中医院眼科，云南	中国中医眼科杂志	里光洗眼液治疗急性卡他性结膜炎疗效观察
谢刘琦	漳州市芗城区通北社区卫生服务中心	眼外伤职业眼病杂志	平阳霉素滴眼预防翼状胬肉术后复发
谢志	黑龙江省齐齐哈尔市五官医院眼科	眼科	基层医院翼状胬肉切除术角膜穿孔并发症二例
谢明捷	泸州医学院附属医院眼科	中国实用眼科杂志	2011年泸州市40岁及以上人群翼状胬肉患病率调查
谢晓蓉	解放军第546医院五官科	国际眼科杂志	带角膜缘干细胞结膜瓣移植治疗复发性翼状胬肉
谢晓谦	南通医学院第二附属医院眼科江苏南通	眼科	低温保存人羊膜移植在重建眼表结构中的临床应用
谢根久	中国湖南省长沙市	国际眼科杂志	春季角结膜炎的治疗进展
谢梅芬	中国湖南省湘潭市中心医院眼科	国际眼科杂志	纤维蛋白胶联合绷带型角膜接触镜在翼状胬肉切除术中的应用
谢汉平	中国重庆第三军医大学西南医院眼科医院	国际眼科杂志	带角膜缘干细胞蒂状结膜瓣和穹窿部蒂状结膜瓣移植治疗翼状胬肉
谢汉平	第三军医大学西南医院眼科	眼外伤职业眼病杂志	翼状胬肉两种不同术式临床疗效对比
谢汉平	重庆第三军医大学西南医院眼科	中国实用眼科杂志	过敏性结膜炎的临床特点
谢汉平	第三军医大学西南医院眼科	中国实用眼科杂志	小牛血去蛋白提取物眼凝胶治疗角膜上皮缺损的多中心临床研究
谢江斌	福建泉州市儿童医院泉州北京同仁眼科中心	中国实用眼科杂志	翼状胬肉保留球结膜根治性切除联合应用丝裂霉素的疗效探讨
谢碧华	中国四川省成都市第一人民医院眼科	国际眼科杂志	翼状胬肉切除联合角膜缘干细胞移植及术后药物治疗临床观察
谢碧华	成都市第一人民医院	中国实用眼科杂志	软性角膜接触镜致巨乳头性结膜炎的治疗
谢祥勇	广西中医药大学附属瑞康医院眼科	临床眼科杂志	准分子激光治疗早期复发性翼状胬肉的临床观察
谢祥勇	广西中医学院附属瑞康医院眼科	国际眼科杂志	角膜塑形镜治疗青少年近视的临床观察
谢立信	山东省眼科研究所、眼科医院	中华眼科杂志	角膜缘干细胞移植术后的穿透性角膜移植疗效观察
谢立科	中山市小榄人民医院眼科	中国中医眼科杂志	平阳霉素治疗早期复发性翼状胬肉疗效观察
谢立科	广东省中山市小榄人民医院眼科	眼外伤职业眼病杂志	新鲜及保存羊膜移植治疗翼状胬肉
谢立科	中山市小榄人民医院眼科	中国中医眼科杂志	自体角膜缘干细胞移植联合丝裂霉素C治疗翼状胬肉的临床研究
谢素贞	厦门大学附属厦门眼科中心	国际眼科杂志	翼状胬肉组织Caveolin-1,E-cadherin和P63的表达
谢美娜	武警浙江总队医院	中国中医眼科杂志	显微镜下自体角膜缘干细胞移植治疗翼状胬肉
谢莉娜	中国南京医科大学附属第一医院眼科	国际眼科杂志	盐酸洛美沙星眼凝胶临床生物等效性试验
谢雷克	河南省科研究所	中华实验眼科杂志	复方酮替芬滴眼剂对实验过敏性结膜炎的疗效观察
谢青	中南大学湘雅医学院附属海口医院	国际眼科杂志	逆行撕除法联合MMC及自体角膜缘干细胞移植治疗翼状胬肉
谭文静	暨南大学附属深圳市眼科医院	国际眼科杂志	改良纤维蛋白粘合剂在眼表翼状胬肉手术中的应用
谭春德	安徽省淮南市晨光眼科医院	临床眼科杂志	自体角膜缘干细胞移植联合准分子激光治疗性角膜切削术治疗翼状胬肉的临床观察
谭晏华	广东省韶关市第一人民医院眼科	临床眼科杂志	新鲜羊膜移植治疗复发性翼状胬肉
谭晏华	韶关市第一人民医院	眼外伤职业眼病杂志	羊膜联合自体角膜缘干细胞移植治疗翼状胬肉
谭洪	中国四川省宜宾市第二人民医院眼科	国际眼科杂志	单眼双侧翼状胬肉联合手术临床疗效观察
谭湘莲	中国湖南省郴州市第一人民医院眼科	国际眼科杂志	羊膜移植与结膜瓣转移治疗复发性翼状胬肉的疗效比较
谭烨	上海市公利医院眼科	临床眼科杂志	表面麻醉在眼科手术中的应用
谭荣强	中国广东省肇庆市第一人民医院眼科	国际眼科杂志	改良羊膜及角膜缘干细胞移植联合MMC治疗复发性翼状胬肉
谭颖谦	广州医学院第二附属医院眼科	中国实用眼科杂志	螨脱敏治疗变应性结膜炎的观察
谭颖谦	广州医学院第二附属医院眼科	中华实验眼科杂志	广东地区变应性结膜炎变应原筛选及预防
谷保民	山东省聊城市光明眼科医院屈光科	中国实用眼科杂志	PRK术后角膜上皮糜烂、剥脱并流行性角结膜炎
贡亦清	江苏省镇江市第一人民医院眼科	中华实验眼科杂志	角膜缘型结膜鳞状上皮乳头状瘤一例
费安裕	台州医院	眼外伤职业眼病杂志	丝裂霉素C在翼状胬肉切除术后的应用
费文雷	中山大学中山眼科中心	中国实用眼科杂志	FK506局部治疗顽固性春季角结膜炎
费文雷	中山大学中山眼科中心	中华眼科杂志	移植物抗宿主病相关的干眼病
费文雷	中山大学中山眼科中心	中华实验眼科杂志	造血干细胞移植术后的眼部观察
贺怡	中国陕西省榆林市第二医院眼科	国际眼科杂志	翼状胬肉手术中应用羊膜移植联合丝裂霉素48眼
贺新征	中国人民解放军113医院眼科	国际眼科杂志	带蒂球结膜瓣转移术治疗翼状胬肉180例的疗效观察
贺燚	河南省眼科研究所	中华实验眼科杂志	人羊膜联合自体角膜缘移植治疗复发性翼状胬肉
贺燚	河南省眼科研究所	中华实验眼科杂志	盐酸左氧氟沙星滴眼液治疗细菌性结膜炎及角膜炎随机双盲对照临床研究
贺红丽	庆阳市人民医院	眼外伤职业眼病杂志	翼状胬肉手术三种不同术式的疗效分析
贺翔鸽	第三军医大学大坪医院野战外科研究所眼科中心	中华实验眼科杂志	准分子激光在翼状胬肉治疗中的应用
贺翔鸽	第三军医大学大坪医院野战外科研究所眼科专科医院	中华眼科杂志	睑结膜缝线致球结膜异物肉芽肿一例
贺翔鸽	第三军医大学第三附属医院眼专科医院	中华眼科杂志	重视长期局部应用抗青光眼药物对眼表组织的损伤
贾佳	天津医科大学眼科临床学院天津市眼科医院天津市眼科研究所	中国实用眼科杂志	儿童期睑腺炎并发眼表疾病68例分析
贾健	中国海洋石油总医院眼科	国际眼科杂志	老年性上睑皮肤松垂及睑内翻矫正术
贾健	渤海石油职工医院眼科	国际眼科杂志	应用雾化疗法治疗流行性出血性角结膜炎临床观察
贾健	海洋石油总医院眼科	国际眼科杂志	可吸收缝线固定移位带角膜缘干细胞结膜瓣术治疗原发性翼状胬肉
贾小云	中山大学中山眼科中心遗传分子生物学实验室	临床眼科杂志	PCR扩增技术在新生儿结膜炎中的诊断应用
贾庆文	通许县人民医院眼科	眼外伤职业眼病杂志	翼状胬肉的几种手术方式及其效果观察
贾延磊	枣庄市立医院	眼外伤职业眼病杂志	自体角膜缘干细胞移植与联合羊膜移植治疗进展期翼状胬肉的临床分析
贾惠莉	中国广东省深圳市眼科医院小儿眼科	国际眼科杂志	盐酸氮卓斯汀滴眼液治疗儿童变态反应性结膜炎的疗效
贾桂芹	天津市眼科医院	中国中医眼科杂志	针刺对Sjogren综合征患者泪液的影响
贾桂芹	天津市眼科医院	临床眼科杂志	手术切除联合贝复舒治疗翼状胬肉的疗效观察
贾桂芹	天津市眼科医院	中国实用眼科杂志	儿童期睑腺炎并发眼表疾病68例分析
贾洪强	中国河北省沧州市	国际眼科杂志	河北省沧州城区6~14岁学龄儿童眼病现况调查
贾玲	南阳市第一人民医院	中华实验眼科杂志	囊腔内注射治疗结膜囊肿32例
贾玲昌	杨州大学医学院附属医院	中国中医眼科杂志	视康滴眼液的药效学研究
贾超	辽宁省抚顺市眼病医院	临床眼科杂志	巩膜暴露区板层角膜移植治疗复发性翼状胬肉
贾长伟	山东省滨州市中心医院眼科	中国实用眼科杂志	复发性翼状胬肉切除角膜缘重建术后泪膜功能变化
赖小兰	暨南大学附属深圳市眼科医院	国际眼科杂志	改良纤维蛋白粘合剂在眼表翼状胬肉手术中的应用
赖小玲	广西壮族自治区人民医院眼科	中华实验眼科杂志	上泪道脓肿漏诊一例
赖小青	解放军101医院眼科	中国中医眼科杂志	翼状胬肉及手术前后对角膜散光的影响
赖小青	解放军101医院眼科	临床眼科杂志	自体角膜缘上皮移植联合贝复舒治疗翼状胬肉的疗效观察
赖纯米	云南省职业病防治研究所	眼外伤职业眼病杂志	接触五硫化二磷工人眼部影响的调查
赖荷	广州医学院第二附属医院眼科	中华实验眼科杂志	广东地区变应性结膜炎变应原筛选及预防
赖荷	广州医学院第二附属医院眼科	中国实用眼科杂志	螨脱敏治疗变应性结膜炎的观察
赫天耕	天津医科大学总医院	眼外伤职业眼病杂志	自体角膜缘上皮移植、羊膜移植与常规术式治疗翼状胬肉复发率的比较
赫天耕	天津医科大学总医院眼科	中华实验眼科杂志	羊膜移植治疗兔眼角膜急性期碱烧伤的实验研究
赫天耕	天津医科大学总医院眼科	中华眼视光学与视觉科学杂志	丝裂霉素C局部贴敷辅助自体角膜缘结膜移植术治疗翼状胬肉
赵东卿	河南省眼科研究所郑州	中华实验眼科杂志	羊膜移植术在治疗大泡性角膜病变中的应用价值
赵东卿	河南省眼科研究所	眼外伤职业眼病杂志	羊膜移植治疗巨大乳头性春季结膜炎
赵丽华	河北省沧州市运河区眼科医院	眼外伤职业眼病杂志	翼状胬肉术中应用丝裂霉素C的临床观察
赵云娥	浙江省温州医学院附属眼视光医院	中华实验眼科杂志	翼状胬肉患者术前和术后泪液功能的临床研究
赵伟	秦皇岛市第一医院	眼外伤职业眼病杂志	自体结膜角膜缘上皮移植治疗翼状胬肉临床观察
赵保文	牡丹江医学院红旗医院眼科	国际眼科杂志	儿童瞬目异常的病因分析
赵保文	牡丹江医学院附属红旗医院眼科	国际眼科杂志	复发性翼状胬肉切除联合角膜缘干细胞移植术或羊膜移植术的疗效比较
赵兰爱	中国广东省肇庆市第一人民医院眼科	国际眼科杂志	改良羊膜及角膜缘干细胞移植联合MMC治疗复发性翼状胬肉
赵兴元	浙江省绍兴市人民医院眼科	眼科	翼状胬肉切除术中丝裂霉素C的应用
赵刚平	中国广东省佛山市第一人民医院眼科	国际眼科杂志	翼状胬肉角膜缘干细胞移植与羊膜移植的比较
赵刚平	佛山市第一人民医院眼科	眼科	人羊膜移植治疗翼状胬肉等眼表疾病的临床观察
赵勇洁	河南科技大学第一附属医院	眼外伤职业眼病杂志	自体带结膜瓣的角膜缘移植治疗翼状胬肉
赵华	河北省沧州眼科医院	中华眼科杂志	板层巩膜移植治愈真菌性巩膜炎一例
赵华	河北省沧州眼科医院	临床眼科杂志	老年性下睑外翻手术治疗的探讨
赵华	中国河北省沧州市	国际眼科杂志	河北省沧州城区6~14岁学龄儿童眼病现况调查
赵博	河南大学淮河医院眼科	中华实验眼科杂志	DNA氧化损伤在翼状胬肉发病中的作用
赵可庆	复旦大学附属眼耳鼻喉科医院耳鼻喉科	中国眼耳鼻喉科杂志	不同螨致敏原对变应性鼻炎患者生活质量的影响
赵坤明	暨南大学医学院附属第四医院眼科	临床眼科杂志	托百士滴眼液治疗眼表细菌性炎症的疗效观察
赵培泉	上海交通大学医学院附属新华医院眼科	中华眼底病杂志	经双目间接检眼镜激光光凝治疗严重早产儿视网膜病变
赵堪兴	天津医科大学眼科临床学院天津市眼科医院天津市眼科研究所	中国实用眼科杂志	儿童期睑腺炎并发眼表疾病68例分析
赵奎卿	延安大学附属医院眼科	国际眼科杂志	双氯芬酸钠滴眼液在翼状胬肉术后的应用
赵学军	焦作煤业集团中央医院眼科	国际眼科杂志	羊膜移植联合丝裂霉素C治疗复发性翼状胬肉
赵宇	中国沈阳铁路中心医院眼科	国际眼科杂志	丝裂霉素C在翼状胬肉转移术中的应用
赵宇丹	沈阳何氏眼科医院	中国实用眼科杂志	纤维蛋白胶在翼状胬肉切除联合无缝线羊膜移植术中应用的临床观察
赵宪孟	中国河南省濮阳市眼科医院临床科	国际眼科杂志	自体带球结膜瓣的角膜缘干细胞移植治疗翼状胬肉
赵家良	北京协和医院眼科	国际眼科杂志	左氧氟沙星滴眼液治疗重症细菌性角膜炎和结膜炎的临床观察
赵小云	天津医科大学眼科中心	国际眼科杂志	云南省怒江州贡山县翼状胬肉的流行病学调查
赵少贞	天津医科大学眼科医院	国际眼科杂志	纤维蛋白胶在翼状胬肉切除联合自体角膜缘干细胞移植术中的临床效果
赵少贞	天津医科大学眼科中心	国际眼科杂志	云南省怒江州贡山县翼状胬肉的流行病学调查
赵少贞	天津医科大学眼科研究所	国际眼科杂志	表面麻醉下翼状胬肉手术中应用纤维蛋白胶的效果
赵峰	复旦大学附属眼耳鼻喉科医院	中华眼视光学与视觉科学杂志	0.1%普拉洛芬滴眼液治疗急性变态反应性结膜炎的疗效
赵峰	复旦大学附属眼耳鼻喉科医院	中国实用眼科杂志	双氯芬酸钠透明质酸钠滴眼液治疗急性变态反应性结膜炎评价
赵峰华	伊犁哈萨克自治州中医医院中西医眼病中心	中国中医眼科杂志	自体角膜缘干细胞结膜移植治疗翼状胬肉
赵峻	北京中医药大学附属东直门医院眼科	中国中医眼科杂志	退赤止痒液治疗春季结膜炎
赵广英	山东省金乡县人民医院	眼外伤职业眼病杂志	角膜异物长期误诊误治三例报告
赵建光	云南省文山州中医院眼科，云南	中国中医眼科杂志	里光洗眼液治疗急性卡他性结膜炎疗效观察
赵建浩	香港中文大学联合汕头国际眼科中心	中国中医眼科杂志	中药低温凉雾超声雾化法治疗春季结膜炎疗效观察
赵德宣	安徽省阜阳市人民医院眼科	眼外伤职业眼病杂志	羊膜移植在眼表疾病中的应用
赵恳	中国湖北省大冶市人民医院眼科	国际眼科杂志	翼状胬肉切除联合角膜干细胞移植术中两种缝合方法对比研究
赵恳	中国湖北省大冶市人民医院眼科	国际眼科杂志	角膜接触镜在翼状胬肉切除术的应用评价
赵惠琼	云南省玉溪市人民医院眼科	中华眼科杂志	结膜真菌病误诊一例
赵愈敏	徐州医学院附属医院眼科	临床眼科杂志	自体角膜缘干细胞联合羊膜移植治疗复发性翼状胬肉
赵慧	厦门大学医学院眼科研究所	中华眼科杂志	双眼蚕蚀性角膜溃疡伴翼状胬肉一例
赵敏	重庆医科大学附属第一医院眼科	中国实用眼科杂志	眼局部用药所致干眼的诊断和治疗
赵敏	重庆医科大学附属第一医院眼科	中国实用眼科杂志	Sj(o)gren综合征发病机制及治疗进展
赵方	中国陕西省榆林市第二医院眼科	国际眼科杂志	低浓度丝裂霉素治疗翼状胬肉的随机、对照研究
赵春娟	台州学院医学院	眼外伤职业眼病杂志	翼状胬肉角膜缘干细胞移植与羊膜移植的比较
赵春明	华中科技大学同济医学院附属协和医院眼科	中华眼科杂志	第15例——双眼疼痛并畏光流泪数日
赵春明	华中科技大学同济医学院附属协和医院眼科	中华实验眼科杂志	β-NGF对人翼状胬肉成纤维细胞增生的影响
赵晓明	神木县眼科医院	眼外伤职业眼病杂志	眼部碱烧伤相关因素分析
赵晓霞	张家口第四医院	中国实用眼科杂志	翼状胬肉切除术致迟发型眼-胃肠反射一例
赵晓霞	中古友好眼科医院	国际眼科杂志	角膜缘干细胞移植治疗翼状胬肉的疗效观察
赵普宁	海南省人民医院眼科	中华实验眼科杂志	应用免疫荧光技术对眼瘢痕性类天疱疮的研究
赵普宁	海口，海南省人民医院眼科	中华眼科杂志	海南省两县(市)翼状胬肉患病率的调查
赵普宁	海南省人民医院眼科	眼科	奥洛他定联合FK506滴眼液治疗儿童严重春季角结膜炎的疗效观察
赵本严	卫生部北京医院眼科	中国眼耳鼻喉科杂志	自体角膜缘上皮结膜瓣移植联合丝裂霉素C治疗复发性翼状胬肉
赵松滨	暨南大学医学院眼科研究室	中华实验眼科杂志	翼状胬肉组织中胶原纤维的病理学改变
赵格	省部共建国家重点实验室培育基地	中华实验眼科杂志	免疫刺激剂CpG ODN防治烟曲霉菌引起的变态反应性结膜炎的实验研究
赵桂秋	青岛大学医学院附属医院眼科	国际眼科杂志	复发性翼状胬肉的治疗分析
赵桂秋	青岛大学医学院附属医院眼科	国际眼科杂志	翼状胬肉患者手术前后泪膜功能的变化
赵桂秋	青岛大学医学院附属医院眼科	中国实用眼科杂志	人工泪液与重组人表皮生长因子衍生物眼液对翼状胬肉术后干眼疗效观察
赵桂秋	青岛大学医学院附属医院眼科	中华实验眼科杂志	1％阿奇霉素滴眼液治疗细菌性结膜炎的随机、双盲、临床对照试验
赵欣	中国北京市第二医院眼科	国际眼科杂志	自体带结膜瓣角膜缘干细胞移植联合羊膜移植治疗复发性翼状胬肉
赵武令	青岛市立医院	中国实用眼科杂志	富马酸酮替芬滴眼液治疗季节变应性结膜炎眼痒及结膜充血的疗效观察
赵永旺	永州职业技术学院附属医院眼科	国际眼科杂志	改良式角膜缘干细胞移位术治疗早期翼状胬肉的临床研究
赵永旺	湖南中医药大学第一附属医院眼科	中国中医眼科杂志	眼科围手术期的中医药治疗
赵永旺	永州职业技术学院附属医院	中国中医眼科杂志	平阳霉素在复发性翼状胬肉中的临床应用
赵江浩	杭州市第一人民医院	中华眼视光学与视觉科学杂志	翼状胬肉切除术后角膜地形图及散光度的改变
赵治河	宿迁市钟吾医院眼科	眼外伤职业眼病杂志	萘敏维联合微量地塞米松在翼状胬肉围手术期应用
赵燕	首都医科大学附属北京同仁医院心理科	国际眼科杂志	精神压力与心因性结膜炎58例的心理治疗
赵燕萍	烟台市牟平区中医院眼科	中国中医眼科杂志	双眼翼状胬肉切除联合角膜缘干细胞移植术的临床应用
赵玲	北京煤炭总医院眼科	临床眼科杂志	120例儿童异常瞬目症的临床分析
赵瑞芹	中国河北邯郸市中心医院眼科	国际眼科杂志	邯郸市区新生儿淋球菌性结膜炎发病的调查
赵秀琴	香港中文大学联合国际眼科中心	国际眼科杂志	角膜缘干细胞移植联合羊膜移植治疗复发性翼状胬肉睑球粘连
赵秀蓉	新疆维吾尔自治区人民医院眼科	眼科	先天性眼皮肤黑变病继发青光眼一例
赵立全	解放军181医院眼科中心	眼外伤职业眼病杂志	光学治疗性角膜切削术治疗复发性翼状胬肉
赵莉	青海红十字医院	眼外伤职业眼病杂志	保存人羊膜移植治疗翼状胬肉临床观察
赵萌	北京市眼科学与视觉科学重点实验室	眼科	儿童瞬目增多现象的背后涵义
赵萌	首都医科大学附属北京同仁医院眼科	国际眼科杂志	鱼腥草滴眼液治疗流行性角膜结膜炎的临床观察
赵萌姗	南方医科大学附属顺德第一人民医院眼科	国际眼科杂志	舌下含服粉尘螨滴剂治疗季节性及常年性过敏性结膜炎
赵萌姗	南方医科大学附属顺德第一人民医院眼科	眼科	顺德地区过敏性结膜炎的变应原检测和治疗分析
赵蓬勃	山东省临邑县人民医院眼科中心	眼外伤职业眼病杂志	角膜缘干细胞移植治疗复发性翼状胬肉
赵薇	大理学院附属医院眼科大理学院临床医学研究中心	国际眼科杂志	青少年糖皮质激素性青光眼10例临床分析
赵薇	安徽省安庆市第二人民医院眼科	临床眼科杂志	翼状胬肉切除联合自体角膜缘结膜移植术疗效分析
赵越筑	绍兴文理学院医学院附属医院眼科	中国实用眼科杂志	西咪替丁治疗重症春季角结膜炎的临床疗效
赵越筑	浙江绍兴文理学院附属医院眼科	中国实用眼科杂志	加替沙星滴眼液治疗细菌性结膜炎临床分析
赵邯英	邯郸市眼科医院	眼外伤职业眼病杂志	泪道冲洗碘必殊眼膏注入联合按压治疗泪小管炎
赵邯英	中国河北邯郸市眼科医院	国际眼科杂志	邯郸市区新生儿淋球菌性结膜炎发病的调查
赵钰	郑州市第二人民医院眼科	眼外伤职业眼病杂志	翼状胬肉手术中无缝线自体角膜缘干细胞移植
赵锡同	乳山市中医院	眼外伤职业眼病杂志	翼状胬肉术中应用丝裂霉素C预防复发的观察
赵长霖	解放军第四五四医院眼科	眼外伤职业眼病杂志	睑球粘连分离术中应用丝裂霉素C的临床观察
赵长龙	安徽省凤台县人民医院眼科	临床眼科杂志	自体角膜缘干细胞移植治疗翼状胬肉
赵静	温州市中西医结合医院	中华眼视光学与视觉科学杂志	翼状胬肉对角膜生物力学特性的影响
赵鸣	武钢第二职工医院眼科	眼外伤职业眼病杂志	5-氟尿嘧啶及丝裂霉素C在翼状胬肉术中的应用
赵黎	上海中医药大学附属普陀医院眼科	国际眼科杂志	利用OCT观察流行性出血性结膜炎的临床研究
赵龙君	郑州大学第一附属医院眼科	眼外伤职业眼病杂志	外伤性眼前段炎症的非甾体抗炎新药--双氯芬酸胆碱滴眼液的研究
越海成	北京市平谷区中医院眼科	中国眼耳鼻喉科杂志	自体角膜缘上皮结膜瓣移植联合丝裂霉素C治疗复发性翼状胬肉
趙東曉	中國廣州中山醫科大學中山眼科中心	国际眼科杂志	羊膜移植治療翼狀胬肉
路九凌	淮阳县安岭卫生院	眼外伤职业眼病杂志	自体角膜缘移植治疗复发性翼状胬肉
车新华	湖北省中山医院眼科	国际眼科杂志	夜戴型角膜塑形镜矫治儿童屈光参差疗效分析
车选义	陕西省人民医院眼科	国际眼科杂志	平阳霉素在翼状胬肉早期干预治疗中的应用
辛云芳	洛宁县人民医院	眼外伤职业眼病杂志	羊膜与自体角膜缘结膜移植治疗翼状胬肉疗效对比
边红林	甘肃省临洮县中医院	眼外伤职业眼病杂志	翼状胬肉显微手术治疗的临床观察
边芳	华中科技大学同济医学院附属协和医院眼科	中华眼科杂志	第15例——双眼疼痛并畏光流泪数日
边芳	华中科技大学同济医学院附属协和医院眼科	临床眼科杂志	姜黄素抑制人血管内皮细胞增殖的研究
边芳	华中科技大学同济医学院附属协和医院眼科	临床眼科杂志	姜黄素抑制翼状胬肉成纤维细胞增生的研究
连燕	福建省南平市第一医院眼科	中国斜视与小儿眼科杂志	新生儿淋菌性结膜炎的临床分析
迪丽娜尔·卡斯木	中国新疆维吾尔自治区喀什地区第二人民医院眼科	国际眼科杂志	维吾尔族翼状胬肉自体角膜干细胞移植128例疗效分析
逯阳	长垣县人民医院	眼外伤职业眼病杂志	羊膜移植治疗翼状胬肉的临床疗效
邓世靖	首都医科大学附属同仁医院	中华实验眼科杂志	武强县小学生沙眼流行病学调查
邓世靖	首都医科大学北京同仁眼科中心	中华眼科杂志	眼局部抗过敏药物的临床应用
邓东方	资兴矿业集团总医院	眼外伤职业眼病杂志	翼状胬肉的三种手术方法疗效比较
邓仁政	重庆三峡中心医院眼科	国际眼科杂志	翼状胬肉切除联合丝裂霉素C及羊膜移植
邓宏伟	中国广东省深圳市眼科医院小儿眼科	国际眼科杂志	盐酸氮卓斯汀滴眼液治疗儿童变态反应性结膜炎的疗效
邓宏伟	深圳市眼科医院	中华实验眼科杂志	翼状胬肉组织中环氧化酶-2及p21-ras的表达研究
邓宏伟	暨南大学附属深圳市眼科医院	眼科	特应性角结膜炎治疗前后共焦显微镜检查二例
邓宏伟	暨南大学附属深圳市眼科医院	国际眼科杂志	泪点炎的临床观察研究
邓宏伟	暨南大学附属深圳市眼科医院	国际眼科杂志	改良纤维蛋白粘合剂在眼表翼状胬肉手术中的应用
邓宏伟	暨南大学医学院附属深圳眼科中心	中华实验眼科杂志	翼状胬肉组织中胶原纤维的病理学改变
邓小玲	湖南桃江县人民医院眼科	眼外伤职业眼病杂志	翼状胬肉手术中带状角膜缘组织移植及丝裂霉素C应用的意义
邓应平	四川大学华西医院眼科	国际眼科杂志	他克莫司治疗春季卡他性角结膜炎的疗效分析
邓德勇	武警浙江总队医院	中国中医眼科杂志	显微镜下自体角膜缘干细胞移植治疗翼状胬肉
邓恕远	天津宝坻县医院眼科	眼外伤职业眼病杂志	羊膜移植治疗复发性翼状胬肉
邓文香	衢州市人民医院眼科	眼外伤职业眼病杂志	翼状胬肉撕离联合角膜缘干细胞移植的研究
邓文香	浙江省衢州市人民医院眼科	中国眼耳鼻喉科杂志	术前控制局部炎症对翼状胬肉术后复发的影响
邓文香	浙江省衢州市人民医院眼科	眼外伤职业眼病杂志	自体角膜缘干细胞移植联合贝复舒治疗翼状胬肉
邓新国	中山大学中山眼科中心	中华实验眼科杂志	汉防己甲素对翼状胬肉成纤维细胞抑制作用的实验研究
邓杏英	暨南大学医学院附属第四医院眼科	临床眼科杂志	托百士滴眼液治疗眼表细菌性炎症的疗效观察
邓江稳	中国人民解放军第五三五医院	眼科	自体角膜缘干细胞移植与羊膜移植治疗翼状胬肉的对比研究
邓法文	山东省东阿县人民医院眼科检验科	中华实验眼科杂志	结膜吸吮线虫病二例
邓洪	海口市人民医院	眼外伤职业眼病杂志	自体角膜缘干细胞移植治疗翼状胬肉临床观察
邓灵锟	广西壮族自治区全州县人民医院眼科	中国眼耳鼻喉科杂志	巩膜裸露区烧灼加丝裂霉素C治疗复发性翼状胬肉
邓玲	湖南省永州市人民医院	中国实用眼科杂志	保存羊膜与新鲜羊膜治疗眼表疾病的比较研究
邓莹莹	湖北医药学院附属太和医院眼科	临床眼科杂志	组织因子在人翼状胬肉中的表达
邓莹莹	湖北医药学院附属太和医院眼科	临床眼科杂志	翼状胬肉手术前后对比敏感度和角膜地形图改变的比较
邓莹莹	郧阳医学院附属太和医院眼科	眼外伤职业眼病杂志	翼状胬肉埋藏法113例
邓莹莹	武汉大学人民医院眼科湖北医药学院附属太和医院眼科	临床眼科杂志	初发性翼状胬肉术中单用利多卡因凝胶与丁卡因滴液表面麻醉效果对比分析
邓里	中国湖南省长沙市第四医院眼科	国际眼科杂志	角膜缘干细胞移植联合羊膜移植治疗翼状胬肉
邓铂林	兰州大学第二医院眼科	国际眼科杂志	甘肃舟曲县藏汉族小学生干眼症的流行病学调查
邓黎明	中国重庆长寿区人民医院眼科	国际眼科杂志	带角膜缘干细胞蒂状结膜瓣和穹窿部蒂状结膜瓣移植治疗翼状胬肉
邝国平	中国湖南省郴州市第一人民医院眼科	国际眼科杂志	Avastin治疗复发性翼状胬肉的临床研究
邝国平	中国湖南省郴州市第一人民医院眼科	国际眼科杂志	羊膜移植与结膜瓣转移治疗复发性翼状胬肉的疗效比较
邢健强	海南医学院附属医院	眼外伤职业眼病杂志	两种术式联合丝裂霉素C治疗翼状胬肉
邢彦仓	北京市平谷区中医院眼科	中国眼耳鼻喉科杂志	自体角膜缘上皮结膜瓣移植联合丝裂霉素C治疗复发性翼状胬肉
邢志芳	浙江省金华市人民医院眼科	中国眼耳鼻喉科杂志	翼状胬肉合并结膜松弛症眼表重建的临床观察
邢怡桥	武汉大学人民医院眼科	中华实验眼科杂志	翼状胬肉切除联合自体球结膜移植术中使用纤维蛋白胶和缝线有效性的随机对照试验的Meta分析
邢怡桥	武汉大学人民医院眼科武汉大学医学院眼科研究所	中国实用眼科杂志	异体巩膜联合多层羊膜移植治疗翼状胬肉术后无菌性角巩膜融解的疗效探讨
邢怡桥	武汉大学人民医院眼科	临床眼科杂志	初发性翼状胬肉术中单用利多卡因凝胶与丁卡因滴液表面麻醉效果对比分析
邢淑惠	中国陕西省西安市第四人民医院眼科	国际眼科杂志	西安周边50岁及以上农村人口眼病调查
邱孝芝	复旦大学附属眼耳鼻喉科医院眼科	临床眼科杂志	羊膜移植联合眼表润滑剂及配镜治疗初发性翼性胬肉
邱孝芝	中国上海复旦大学附属眼耳鼻喉科医院眼科	国际眼科杂志	翼状胬肉手术方法的改进
邱孝芝	复旦大学附属眼耳鼻喉科医院眼科	中国眼耳鼻喉科杂志	羊膜移植在结膜重建中的应用
邱孝芝	复旦大学附属眼耳鼻喉科医院眼科	中华眼科杂志	异体巩膜移植治疗复发性瘢痕性睑内翻的临床分析
邱德来	天津医科大学眼科临床学院	中华实验眼科杂志	儿童急性结膜炎后长期干眼一例
邱慎华	山东淄博市第一医院眼科	眼科	翼状胬肉切除术后平阳霉素的使用
邱承敏	中国上海市松江区中心医院眼科	国际眼科杂志	翼状胬肉基质金属蛋白酶表达的意义
邱晓頔	复旦大学附属眼耳鼻喉科医院眼科	中华眼科杂志	加替沙星和左氧氟沙星治疗细菌性结膜炎的疗效对比研究
邱璐璐	牡丹江医学院附属红旗医院眼科	国际眼科杂志	复发性翼状胬肉切除联合角膜缘干细胞移植术或羊膜移植术的疗效比较
邱璐璐	牡丹江医学院红旗医院眼科	国际眼科杂志	儿童瞬目异常的病因分析
邱翎	温州医学院附属第一医院眼科	临床眼科杂志	自体角膜缘上皮移植术联合羊膜移植术治疗复发性翼状胬肉的临床分析
邱芳芳	厦门大学医学院眼科研究所	中华眼科杂志	双眼蚕蚀性角膜溃疡伴翼状胬肉一例
邱芳芳	厦门眼科中心	中国斜视与小儿眼科杂志	厦门市思明区3～6岁儿童眼病调查
邱辉	中国沈阳铁路中心医院眼科	国际眼科杂志	丝裂霉素C在翼状胬肉转移术中的应用
邵东平	新乡医学院	中国斜视与小儿眼科杂志	双眼球后退综合征伴"鳄鱼泪"一例
邵冬	北华大学附属医院眼科	中华眼底病杂志	双眼后巩膜炎一例
邵利琴	浙江绍兴文理学院附属医院眼科	中国实用眼科杂志	加替沙星滴眼液治疗细菌性结膜炎临床分析
邵杰	郧阳医学院附属十堰市人民医院眼科	国际眼科杂志	YAG泪道激光联合丝裂霉素及典必殊眼膏治疗泪道阻塞89例
邵正荣	复旦大学附属华山医院南汇分院眼科	国际眼科杂志	翼状胬肉切除改良术式的临床观察
邵正荣	复旦大学附属华山医院南汇分院眼科	国际眼科杂志	翼状胬肉切除联合球结膜下生物羊膜移植的初步研究
邵毅	南昌大学第一附属医院眼科	中国眼耳鼻喉科杂志	丝裂霉素C在眼科应用进展
邵玉红	洛阳一拖中心医院	中华实验眼科杂志	正常人与Sjogren综合征患者唇腺免疫细胞的研究
邵芳莲	政和县医院	眼外伤职业眼病杂志	生物羊膜治疗翼状胬肉的临床观察
邸平会	河北省邢台市眼科医院	中国中医眼科杂志	华蟾素局部注射治疗翼状胬肉
邸新	中國沈陽何氏眼科醫院，	国际眼科杂志	帶蒂球結膜與角膜緣上皮移植治療翼狀胬肉
邸新	沈阳何氏眼科医院	中国实用眼科杂志	纤维蛋白胶在翼状胬肉切除联合无缝线羊膜移植术中应用的临床观察
邹亚军	河北省辛集市辛集复明医院	临床眼科杂志	睑板腺分泌物性质异常的临床观察
邹会会	潍坊医学院眼科学教研室	中华实验眼科杂志	麦考酚酸抑制翼状胬肉成纤维细胞的作用机制
邹娟	中国湖北省襄樊市中心医院眼科	国际眼科杂志	高频电灼浚通术治疗泪道阻塞的疗效观察
邹媛	三峡大学第一临床医学院	中华实验眼科杂志	过氧化物酶体增生物激活受体激动剂对翼状胬肉成纤维细胞增生的抑制作用
邹媛媛	天津医科大学眼科中心	国际眼科杂志	云南省怒江州贡山县翼状胬肉的流行病学调查
邹学公	山东省莱芜市中医院	中国中医眼科杂志	角膜缘干细胞移植联合胬肉切除术治疗翼状胬肉56例
邹明霞	山西轩岗矿务局医院儿科	中华眼科杂志	过敏性结膜炎变应原检查
邹海东	上海交通大学附属第一人民医院眼科	国际眼科杂志	影响上海市外来务工子弟小学学生沙眼患病相关因素的调查研究
邹留河	首都医科大学附属同仁眼科中心	眼科	翼状胬肉大小与角膜地形图的相关性研究
邹留河	北京同仁医院眼科	中国实用眼科杂志	翼状胬肉保留球结膜根治性切除联合应用丝裂霉素的疗效探讨
邹留河	首都医科大学附属北京同仁医院	中国实用眼科杂志	小牛血去蛋白提取物眼凝胶治疗角膜上皮缺损的多中心临床研究
邹留河	北京市眼科学与视觉科学重点实验室	眼科	儿童瞬目增多现象的背后涵义
邹留河	北京同仁医院眼科	眼科	羊膜移植联合带结膜瓣自体角膜缘移植及丝裂霉素C治疗多次复发性翼状胬肉
邹留河	首都医科大学附属北京同仁医院眼科	国际眼科杂志	鱼腥草滴眼液治疗流行性角膜结膜炎的临床观察
邹留河	首都医科大学附属北京同仁医院眼科中心	眼科	充分认识儿童过敏性结膜炎的干眼症问题
邹粤丽	安徽省淮南市晨光眼科医院	临床眼科杂志	自体角膜缘干细胞移植联合准分子激光治疗性角膜切削术治疗翼状胬肉的临床观察
邹雄	广东省茂名市中医院眼科	中华实验眼科杂志	淋菌性结膜炎78例临床分析
郁建平	中国江苏省姜堰市人民医院眼科	国际眼科杂志	自体角膜缘干细胞移植联合MMC治疗翼状胬肉疗效观察
郁想想	武汉大学人民医院眼科	临床眼科杂志	春季卡他性结膜炎的药物治疗疗效观察
郁继国	温州医学院附属眼视光医院	中华眼视光学与视觉科学杂志	翼状胬肉对角膜生物力学特性的影响
郑丹	浙江省台州市中心医院眼科	临床眼科杂志	翼状胬肉手术治疗不同术式的比较
郑丹	台州市中心医院眼科	中国中医眼科杂志	翼状胬肉手术不同术式的比较
郑云燕	海口市人民医院	眼外伤职业眼病杂志	自体角膜缘干细胞移植治疗翼状胬肉临床观察
郑亦君	武汉科技大学附属天佑医院	眼外伤职业眼病杂志	风湿病患者双眼翼状胬肉术后发生坏死性巩膜炎
郑伊春	栾川县人民医院	眼外伤职业眼病杂志	翼状胬肉逆行切除角膜缘干细胞移植临床观察
郑伟	湖北省宜昌市夷陵医院眼科	中国眼耳鼻喉科杂志	氟康唑联合聚维酮碘治疗真菌性结膜炎
郑剑秋	赤壁市人民医院	眼外伤职业眼病杂志	眼内异物存留致失明两例
郑卫东	福建医科大学附属第一医院眼科	眼科	自体角膜缘干细胞移植治疗翼状胬肉
郑卫东	福建医科大学附属第一医院福建省眼科研究所	中国实用眼科杂志	翼状胬肉中细胞增殖与凋亡相关基因蛋白的表达及其意义
郑卫东	福建医科大学第一附属医院	中华眼视光学与视觉科学杂志	基质金属蛋白酶-1及其抑制剂和转化生长因子-β1在翼状胬肉中的表达及意义
郑大风	郧阳医学院附属太和医院眼科	眼外伤职业眼病杂志	翼状胬肉埋藏法113例
郑学栋	福建医科大学第一附属医院	中华眼视光学与视觉科学杂志	基质金属蛋白酶-1及其抑制剂和转化生长因子-β1在翼状胬肉中的表达及意义
郑小薇	汕头大学医学院第一附属医院眼科	眼科	老年人带状疱疹性眼病的特点
郑小薇	汕头大学医学院第一附属医院眼科	临床眼科杂志	翼状胬肉术后滴用0.05g/L丝裂霉素C的疗效观察
郑建奇	益阳医学高等专科学校附属医院眼科	国际眼科杂志	不同翼状胬肉手术方式对角膜屈光的影响
郑微	河北省儿童医院眼科	中国实用眼科杂志	儿童睑缘耻阴虱感染一例
郑慧君	广东省汕尾逸挥基金医院眼科	中国实用眼科杂志	翼状胬肉不同手术方法疗效分析
郑敏	东营市人民医院	眼外伤职业眼病杂志	纤维蛋白胶在翼状胬肉切除联合自体角膜缘干细胞移植术中的应用研究
郑新富	祁门县灯塔眼科医院	眼外伤职业眼病杂志	不同术式治疗翼状胬肉临床观察
郑新朋	祁门县灯塔眼科医院	眼外伤职业眼病杂志	不同术式治疗翼状胬肉临床观察
郑曰忠	天津市眼科医院	中国实用眼科杂志	天津市大港区中老年人翼状胬肉的流行病学调查
郑曰忠	天津眼科医院	中国中医眼科杂志	眼酒糟鼻57例临床观察
郑曰忠	天津眼科医院	中国中医眼科杂志	睑角结膜炎病例临床表现及疗效分析
郑松泉	浙江省湖州市第一人民医院眼科研究所	中华实验眼科杂志	翼状胬肉术后巩膜融解分析
郑根主	河北廊坊中国石油中心医院	中国中医眼科杂志	VEGF与PCNA在翼状胬肉中的表达
郑海生	中山大学附属第二医院眼科	中国实用眼科杂志	姜黄素在眼科应用的研究和进展
郑燕林	成都中医药大学附属医院眼科	中国中医眼科杂志	苦参碱对体外培养人翼状胬肉成纤维细胞增殖的影响
郑玉萍	中国西安交通大学第二医院眼科	国际眼科杂志	自体角膜缘移植联合新鲜羊膜治疗复发性翼状胬肉
郑琦	河北廊坊中国石油中心医院	中国中医眼科杂志	VEGF与PCNA在翼状胬肉中的表达
郑瑜	广州医学院第二附属医院眼科	中华实验眼科杂志	广东地区变应性结膜炎变应原筛选及预防
郑秋香	福建省龙岩市第一医院眼科	中国眼耳鼻喉科杂志	慢性结膜炎患者中干眼症的患病率
郑红	福建省三明市第一医院遗传研究室	中华实验眼科杂志	睑结膜部炎症者肺炎衣原体、沙眼衣原体核酸检测
郑美琴	温州医学院附属眼视光医院检验科	中华眼视光学与视觉科学杂志	衣氏放线菌致结膜感染1例
郑芳	吉首市人民医院	眼外伤职业眼病杂志	自体角膜缘干细胞移植治疗翼状胬肉378例
郑茜	中国辽宁省辽阳市第三人民医院眼科	国际眼科杂志	自体角膜缘干细胞移植术治疗原发性翼状胬肉94例
郑诚	中国广东省肇庆市第一人民医院眼科	国际眼科杂志	改良羊膜及角膜缘干细胞移植联合MMC治疗复发性翼状胬肉
郑远远	首都医科大学北京同仁眼科中心	中华眼科杂志	北京特定地区翼状胬肉患病率的流行病学调查
郑远远	首都医科大学附属北京同仁医院	眼科	北京市城乡限定人群白内障手术负荷量及术后视力评价
郑霄	佛山市第一人民医院眼科	眼科	人羊膜移植治疗翼状胬肉等眼表疾病的临床观察
郑霄	中国广东省佛山市第一人民医院眼科	国际眼科杂志	翼状胬肉角膜缘干细胞移植与羊膜移植的比较
郑韵哲	辽宁省辽阳市第201医院五官科	临床眼科杂志	翼状胬肉手术切除与冷冻治疗的疗效对比观察
郝俊华	邯郸眼科医院眼科	国际眼科杂志	应用准分子激光角膜切削术治疗翼状胬肉的临床观察
郝俊华	河北邯郸市眼科医院眼科	中国实用眼科杂志	翼状胬肉切除联合准分子激光治疗性角膜切削术与角膜缘干细胞移植术疗效对比观察
郝俊华	中国河北省邯郸市眼科医院	国际眼科杂志	翼状胬肉手术治疗研究进展
郝兆芹	中国陕西省西安市第一医院眼科	国际眼科杂志	原发性翼状胬肉与干眼关系的临床观察
郝君	龙口市人民医院眼科	中国中医眼科杂志	翼状胬肉术后复发的早期临床表现——角膜上皮修复不良
郝宇	武警上海总队医院眼科	临床眼科杂志	干眼症误诊的临床分析
郝尚臣	郑州大学第一附属医院眼科	中华实验眼科杂志	翼状胬肉细胞之间的相互作用
郝尚臣	郑州大学第一附属医院	眼外伤职业眼病杂志	紫外线对翼状胬肉细胞的作用
郝念	华中科技大学同济医学院附属协和医院眼科	中华实验眼科杂志	来氟米特活性代谢物A77 1726对翼状胬肉成纤维细胞增生的影响
郝慧	安徽省萧县人民医院眼科	眼外伤职业眼病杂志	角膜缘异物误诊一例
郝琦琦	遵义医学院第五附属珠海医院眼科	眼外伤职业眼病杂志	两种翼状胬肉结膜移植手术美容效果观察
郝琳娜	牡丹江医学院红旗医院一门诊眼2科	眼外伤职业眼病杂志	铁水烧伤继发假性翼状胬肉的治疗一例
郝绮红	中国广东省广州市第一人民医院眼科	国际眼科杂志	亲水性软性角膜接触镜在眼表疾病治疗中的疗效观察
郝进	中国中医科学院眼科医院	中国中医眼科杂志	目痒证治1例
郭业兵	山东省东阿县人民医院眼科病理科	中华实验眼科杂志	结膜吸吮线虫病二例
郭乃银	陕西省宝鸡市解放军第三医院眼科	中华眼视光学与视觉科学杂志	眼毛囊异位症合并睑板腺囊肿1例
郭亚琴	湖北省仙桃市中医院眼科	临床眼科杂志	翼状胬肉切除结膜瓣转位包埋术疗效观察
郭倩芳	汝阳县人民医院	眼外伤职业眼病杂志	自体结膜角膜缘干细胞移植治疗翼状胬肉
郭健	福州市第二医院眼科	中国实用眼科杂志	翼状胬肉的发生与角膜缘干细胞缺乏的病理研究
郭健华	辽宁省鞍山市中心医院	中华眼视光学与视觉科学杂志	泪阜瘘管误诊1例
郭健华	鞍山市中心医院眼科	中华实验眼科杂志	泪阜瘘管误诊一例
郭华	海军青岛401医院眼科	眼外伤职业眼病杂志	不同部位角膜干细胞移植治疗翼状胬肉的疗效分析
郭向明	中山大学中山眼科中心遗传分子生物学实验室	临床眼科杂志	PCR扩增技术在新生儿结膜炎中的诊断应用
郭向欣	邹城市人民医院	眼外伤职业眼病杂志	自体角膜缘干细胞联合结膜移植治疗翼状胬肉
郭向欣	中国山东省邹城市人民医院眼科	国际眼科杂志	大范围切除联合新鲜羊膜移植治疗复发性翼状胬肉
郭妮娜	广东省汕尾市逸挥基金医院眼科	临床眼科杂志	翼状胬肉角膜表面屈光状态分析
郭姝莹	中国陕西省大荔县人民医院	国际眼科杂志	翼状胬肉两种手术治疗的比较
郭学龙	广东省佛山市第五人民医院眼科	临床眼科杂志	翼状胬肉两种手术方法的临床效果比较
郭小东	广东省第二人民医院眼科	中国实用眼科杂志	联合颞部注射治疗急性细菌结膜炎
郭小东	广东省第二人民医院眼科	中国实用眼科杂志	曲安奈德治疗复发性翼状胬肉24例疗效观察
郭崧	北京博雅康泰生物工程科技有限公司	中国中医眼科杂志	秦菊滴眼液治疗家兔实验性结膜炎的实验研究
郭平英	遵义医学院第五附属	国际眼科杂志	翼状胬肉上结膜反向移植联合生物羊膜治疗复发性翼状胬肉
郭建强	西安市中心医院眼科	临床眼科杂志	角膜缘干细胞移植加丝裂霉素C棉片浸放与新鲜羊膜移植治疗翼状胬肉的对比观察
郭建强	西安市中心医院眼科	临床眼科杂志	角膜缘干细胞移植联合丝裂霉素C应用对抑制翼状胬肉复发的初步观察
郭德芳	湖北省宜昌市夷陵医院眼科	中国眼耳鼻喉科杂志	氟康唑联合聚维酮碘治疗真菌性结膜炎
郭慧	中山大学附属第二医院眼科	国际眼科杂志	逆行镊撕法联合3种手术方式预防翼状胬肉复发的疗效分析
郭慧宇	中国吉林省四平市中心人民医院眼科	国际眼科杂志	骨髓间充质干细胞羊膜片移植治疗翼状胬肉的观察和护理
郭晓曼	广西南宁市第一人民医院	眼外伤职业眼病杂志	保存人羊膜在眼表疾病中的应用
郭晓玲	深圳广东边防武警总队医院眼科	眼外伤职业眼病杂志	排多癌防治翼状胬肉术后复发疗效观察
郭晓飞	河北省唐山市眼科医院	中国斜视与小儿眼科杂志	215例儿童频繁瞬目病因分析
郭月英	中国新疆维吾尔自治区乌鲁木齐市	国际眼科杂志	翼状胬肉标准化手术治疗的疗效
郭朝广	中国河南省濮阳市眼科医院临床科	国际眼科杂志	自体带球结膜瓣的角膜缘干细胞移植治疗翼状胬肉
郭桂兰	郧阳医学院附属十堰市人民医院眼科	国际眼科杂志	YAG泪道激光联合丝裂霉素及典必殊眼膏治疗泪道阻塞89例
郭欣璐	中国中医科学院眼科医院	中国中医眼科杂志	川椒方治疗过敏性结膜炎的临床观察
郭歆星	中山大学中山眼科中心眼科学国家重点实验室	中华眼科杂志	透明质酸钠对兔含苯扎氯铵溴莫尼定眼表毒性保护作用的研究
郭海玉	中国陕西省西安市第四人民医院眼科	国际眼科杂志	西安周边50岁及以上农村人口眼病调查
郭海科	广东省眼病防治研究所广东省人民医院眼科	中国实用眼科杂志	基层医院早产儿视网膜病变筛查方式及筛查标准探讨
郭涛	第二军医大学附属长海医院眼科	临床眼科杂志	翼状胬肉切除联合羊膜或自体角膜缘干细胞移植术的临床应用研究
郭涛	上海市杨浦区中心医院眼科	中华实验眼科杂志	翼状胬肉组织中CD_(34)、AC133、STRO 1、C KIT的表达
郭玉敏	昆明医学院第四附属医院眼科	中华实验眼科杂志	睑缘切开带蒂轮匝肌瓣充填术治疗严重上睑内翻倒睫疗效观察
郭玉敏	云南省红十字会医院眼科	中华实验眼科杂志	自体角膜缘与结膜移植治疗复发性翼状胬肉
郭疆	中国广东省深圳市第二人民医院眼科	国际眼科杂志	翼状胬肉切除法与撕除法术后疼痛的对比研究
郭祖文	暨南大学医学院电镜中心	中华实验眼科杂志	翼状胬肉组织中胶原纤维的病理学改变
郭素萍	贵州航天医院	眼外伤职业眼病杂志	初发翼状胬肉单纯切除联合丝裂霉素C的治疗观察
郭维仪	广东省佛山市南海区大沥医院眼科	中国实用眼科杂志	复发性翼状胬肉角膜缘干细胞移植远期疗效观察
郭莉	中山大学中山眼科中心遗传分子生物学实验室	临床眼科杂志	PCR扩增技术在新生儿结膜炎中的诊断应用
郭萍	暨南大学附属深圳市眼科医院	眼科	特应性角结膜炎治疗前后共焦显微镜检查二例
郭萍	山东省眼科研究所、眼科医院	中华眼科杂志	角膜缘干细胞移植术后的穿透性角膜移植疗效观察
郭萍	暨南大学附属深圳市眼科医院角膜病科	国际眼科杂志	羊膜移植术治疗重症春季卡他性结膜炎的疗效分析
郭锐	巢湖市脱氏眼科医院	眼外伤职业眼病杂志	角膜缘干细胞移植与丝裂霉素C治疗翼状胬肉
郭露萍	广州医学院第二附属医院眼科	中华眼科杂志	翼状胬肉显微手术方法及其疗效观察
郭露萍	广州医学院第二附属医院眼科	中华实验眼科杂志	广东地区变应性结膜炎变应原筛选及预防
郭青	解放军总医院第304临床部眼科	中国实用眼科杂志	羊膜和角膜干细胞移植治疗眼表疾病临床观察
郭青	解放军总医院第一附属医院眼科	国际眼科杂志	自体角膜缘干细胞移植与自体体外培养角膜干细胞移植治疗翼状胬肉临床观察
郭静	湖南省岳阳市三人民医院眼科	中国眼耳鼻喉科杂志	翼状胬肉逆行切除联合自体结膜或角膜缘干细胞移植术的疗效观察
郭黎霞	邯郸市眼科医院	眼外伤职业眼病杂志	泪道冲洗碘必殊眼膏注入联合按压治疗泪小管炎
鄭岩	中國上海第二醫科大學附屬新華醫院眼科	国际眼科杂志	頭孢三嗪噻肟治瘵淋菌性結膜炎42例
酒旭东	兰州大学第二医院眼科	国际眼科杂志	甘肃舟曲县藏汉族小学生干眼症的流行病学调查
金中秋	广州军区武汉总医院眼底科	国际眼科杂志	治疗性软性角膜接触镜在翼状胬肉手术中的应用和评价
金基宁	杨州大学医学院附属医院	中国中医眼科杂志	视康滴眼液的药效学研究
金姬	浙江省金华市中心医院眼科	中华实验眼科杂志	PEDF和VEGF在翼状胬肉组织中的不平衡表达
金姬	中国浙江省金华市中心医院眼科	国际眼科杂志	翼状胬肉组织PEDF和VEGF的不平衡表达
金威尔	福建省人民医院眼科	中国中医眼科杂志	眼痒安I号雾化治疗春季结膜炎疗效观察
金威尔	福建省人民医院眼科	中国中医眼科杂志	羊膜移植并除风益损汤加减治疗翼状胬肉
金威尔	福建中医学院附属人民医院眼科	中国中医眼科杂志	清开灵和干扰素对翼状胬肉成纤维细胞增殖的影响
金威尔	福建省人民医院眼科	中华眼视光学与视觉科学杂志	细胞因子对翼状胬肉成纤维细胞增殖的影响
金婉卿	温州医学院附属眼视光医院	中华眼视光学与视觉科学杂志	翼状胬肉患者屈光状态的检测
金婉卿	温州医学院眼视光学院	中国实用眼科杂志	高透氧性硬性角膜接触镜治疗屈光参差性弱视的疗效评估
金学海	中国医科大学附一院眼科	眼外伤职业眼病杂志	准分子激光原位角膜磨镶术后并发病毒性角膜炎一例
金怡萍	同济大学附属东方医院	中国眼耳鼻喉科杂志	翼状胬肉剪除术的临床疗效观察
金慶新	中國西安兵器工業521醫院眼科	国际眼科杂志	自體角膜缘上皮移植聯合缘裂霉素C治瘵翼狀胬肉的臨床觀察
金明	中日友好医院	中国中医眼科杂志	春季角结膜炎中医药治疗最新进展
金明	中日友好医院眼科	中华眼科杂志	禽流感病毒结膜炎的流行及其眼嗜性的分子基础
金智生	甘肃中医学院内科	国际眼科杂志	平阳霉素注射治疗翼状胬肉的临床观察
金涛	首都医科大学附属北京同仁医院	中国实用眼科杂志	小牛血去蛋白提取物眼凝胶治疗角膜上皮缺损的多中心临床研究
金涛	首都医科大学附属北京同仁医院眼科	国际眼科杂志	鱼腥草滴眼液治疗流行性角膜结膜炎的临床观察
金玲	中国广东省深圳市宝安区人民医院眼科	国际眼科杂志	Survivin蛋白和Fas蛋白在原发性翼状胬肉中的表达及其相关性研究
金玲	武警上海总队医院眼科	临床眼科杂志	干眼症误诊的临床分析
金秀英	北京市眼科研究所	中华眼科杂志	沙眼衣原体--发现与贡献
金秀英	首都医科大学附属北京同仁医院眼科中心	眼科	沙眼衣原体研究历程及进展
金秀英	北京市眼科研究所微生物室	中华眼视光学与视觉科学杂志	44例真菌性角结膜炎患者真菌培养及药敏试验结果分析
金秀英	首都医科大学附属北京同仁医院跟科中心北京市眼科研究所	眼科	北京农村老年居民翼状胬肉患病情况分析
金鑫	中国陕西省西安市红庙坡医院中视眼病中心	国际眼科杂志	干细胞移植联合抗代谢药物治疗翼状胬肉
金龙儒	中国陕西省西安市红庙坡医院中视眼病中心	国际眼科杂志	干细胞移植联合抗代谢药物治疗翼状胬肉
钟一声	上海第二医科大学附属瑞金医院眼科	眼外伤职业眼病杂志	翼状胬肉术中丝裂霉素不同留置时间的效果
钟一声	上海第二医科大学附属瑞金医院眼科	中华眼科杂志	翼状胬肉中碱性成纤维细胞生长因子的表达及其与肥大细胞的关系
钟世强	中国广东省梅州市嘉应学院医学院附属医院眼科	国际眼科杂志	角膜缘干细胞联合羊膜移植治疗翼状胬肉疗效观察
钟丘	广东省中山火炬开发区医院眼科	国际眼科杂志	不同手术方式对翼状胬肉患者泪液功能的影响
钟刘学颖	中山大学中山眼科中心	国际眼科杂志	左氧氟沙星滴眼液治疗重症细菌性角膜炎和结膜炎的临床观察
钟建光	杭州市第一人民医院眼科	中国中医眼科杂志	自体带角膜缘干细胞的结膜瓣移位术治疗翼状胬肉
钟建胜	南阳市眼科医院	眼外伤职业眼病杂志	自体角膜缘上皮移植治疗翼状胬肉疗效观察
钟文贤	江西省人民医院眼科	中国实用眼科杂志	保存人羊膜移植治疗难治性眼表疾病的临床效果
钟新娜	浙江省湖州市中医院眼科	临床眼科杂志	翼状胬肉手术时机的临床研究
钟晓东	郧阳医学院附属十堰市人民医院眼科	国际眼科杂志	YAG泪道激光联合丝裂霉素及典必殊眼膏治疗泪道阻塞89例
钟晖	深圳市儿童医院眼科	临床眼科杂志	FK506在实验性过敏性结膜炎局部免疫调控的作用
钟晖	深圳市儿童医院眼科	国际眼科杂志	FK506对实验性过敏性结膜炎细胞因子表达的影响
钟晖	深圳市儿童医院眼科	临床眼科杂志	累及眼部的Stevens-Johnson综合征1例
钟松华	岱山县第一人民医院	眼外伤职业眼病杂志	新鲜人羊膜移植治疗翼状胬肉的临床观察
钟松华	浙江省岱山县第一人民医院眼科	眼外伤职业眼病杂志	自体角膜缘干细胞移植治疗翼状胬肉
钟毅敏	中山大学中山眼科中心眼科学国家重点实验室	中华眼科杂志	透明质酸钠对兔含苯扎氯铵溴莫尼定眼表毒性保护作用的研究
钟烈红	海口，海南省人民医院眼科	中华眼科杂志	海南省两县(市)翼状胬肉患病率的调查
钟瑞佳	沈阳爱尔眼视光医院	中国实用眼科杂志	泪腺导管囊肿一例
钟瑞佳	沈阳爱尔眼视光医院	中国实用眼科杂志	外眦角泪腺排泄管异物二例
钟福炉	中国人民解放军第一八○医院眼科	国际眼科杂志	滑行移植自体角膜缘干细胞联合丝裂霉素C治疗翼状胬肉
钱国祥	海门市刘浩医院	眼外伤职业眼病杂志	巩膜灼烙和结膜瓣移位联合治疗复发性胬肉
钱学翰	天津医科大学眼科临床学院、天津市眼科医院	中华眼底病杂志	后巩膜炎继发急性浅前房一例
钱定国	浙江省舟山市普陀人民医院眼科	中国中医眼科杂志	翼状胬肉切除术后辅用中药的疗效观察
钱志刚	武汉大学中南医院眼科	临床眼科杂志	结膜松弛症的临床及病理研究
钱永勤	浙江舟山警备区医院眼科	眼外伤职业眼病杂志	自体结膜瓣转移治疗翼状胬肉240例临床观察
钱江	复旦大学附属眼耳鼻喉科医院	中华眼科杂志	眼部自然杀伤-T细胞淋巴瘤致角膜穿孔一例
钱江	复旦大学附属眼耳鼻喉科医院	中华眼视光学与视觉科学杂志	还原型谷胱甘肽滴眼液促进翼状胬肉术后角膜上皮修复
钱爱华	湖北中医学院附属医院眼科	中国中医眼科杂志	春卡灵汤治疗春季卡他性结膜炎临床观察
银哲	中国山东省邹城市人民医院眼科	国际眼科杂志	大范围切除联合新鲜羊膜移植治疗复发性翼状胬肉
镇华	宁波光明眼病医院	眼外伤职业眼病杂志	结膜瓣转位移植联合丝裂霉素C治疗翼状胬肉临床观察
镡鲁滨	解放军401医院眼科	国际眼科杂志	自体角膜缘上皮移植和羊膜移植治疗翼状胬肉107例
闫仲朝	河南省淇县人民医院眼科	眼外伤职业眼病杂志	羊膜移植治疗巨大乳头性春季结膜炎
闫光辉	中国宁夏回族自治区银川市	国际眼科杂志	宁夏地区翼状胬肉患病率的流行病学调查
闫光辉	中国宁夏回族自治区银川市	国际眼科杂志	宁夏地区沙眼患病率流行病学调查
闫宗龙	禹州市人民医院	眼外伤职业眼病杂志	改良自体角膜干细胞移植术治疗翼状胬肉初步观察
闫峰	南京军区南京总医院眼科	中华实验眼科杂志	泡性眼炎的激光扫描共焦显微镜下表现
闫晓丽	乌鲁木齐市眼耳鼻喉医院	临床眼科杂志	翼状胬肉切除羊膜移植术后坏死性巩膜炎3例
闫素清	郑州大学公共卫生学院卫生化学教研室	眼外伤职业眼病杂志	外伤性眼前段炎症的非甾体抗炎新药--双氯芬酸胆碱滴眼液的研究
闫蕾	厦门大学附属厦门眼科中心	国际眼科杂志	翼状胬肉组织Caveolin-1,E-cadherin和P63的表达
闫静君	河南省淇县人民医院眼科	眼外伤职业眼病杂志	羊膜移植治疗巨大乳头性春季结膜炎
闵宗英	浙江省绍兴市人民医院眼科	中国实用眼科杂志	翼状胬肉切除术中与术后应用丝裂霉素C的比较
闻矩	沈阳市爱尔眼视光医院	中国实用眼科杂志	自体角膜缘干细胞移植联合丝裂霉素C治疗翼状胬肉疗效观察
阎启昌	中国医科大学附属第四医院眼科	国际眼科杂志	层黏连蛋白对人翼状胬肉成纤维细胞生长的抑制作用
阙传红	河南医科大学第一附属医院眼科	眼外伤职业眼病杂志	开睑钩翻转眼睑用于沙眼手术的体会
阚秋霞	第三军医大学大坪医院野战外科研究所眼科中心	中华实验眼科杂志	准分子激光在翼状胬肉治疗中的应用
阮敏毅	福建医科大学附属漳州市医院眼科	国际眼科杂志	自体角膜缘干细胞移植术治疗复发性翼状胬肉疗效观察
阮敏毅	漳州市医院眼科	眼科	自体结膜瓣转位移植治疗翼状胬肉
阴正勤	第三军医大学西南医院	中国实用眼科杂志	原发性结膜肿瘤728例临床病理分析
阴秀霞	西安交通大学医学院第一附属医院	临床眼科杂志	翼状胬肉切除联合角膜缘干细胞移植术远期疗效分析
陆勤康	宁波市鄞州人民医院	中国实用眼科杂志	翼状胬肉不同术式效果观察
陆君如	无锡市第二人民医院眼科	中国实用眼科杂志	肉眼下翼状胬肉切除联合自体角膜缘干细胞移植临床分析
陆培荣	苏州大学附属第一医院眼科	中国实用眼科杂志	MMP-3、MMP-8在翼状胬肉中的表达
陆培荣	苏州大学附属一院眼科	国际眼科杂志	MMP-8在翼状胬肉中的表达
陆宏	南通大学附属医院	中国实用眼科杂志	翼状胬肉bFGF TNF-α p53表达的研究
陆慧红	上海市眼病防治中心	眼外伤职业眼病杂志	双眼皮质类固醇性青光眼一例
陆慧红	上海市眼病防治中心	中华眼科杂志	结膜松弛症球结膜组织中热休克蛋白的表达
陆慧红	上海交通大学医学院附属第九人民医院眼科上海交通大学医学院眼科视觉科学研究所	中华眼视光学与视觉科学杂志	上海市艾滋病初诊患者眼部并发症及致盲原因调查分析
陆斌	浙江湖州第一人民医院眼科	中国眼耳鼻喉科杂志	角膜上皮分离术应用于翼状胬肉切除
陆滨	浙江省长兴县人民医院眼科	中国眼耳鼻喉科杂志	两种术式治疗翼状胬肉的疗效对比
陆绍强	广西百色地区人民医院	眼外伤职业眼病杂志	自身角膜缘结膜移植治疗翼状胬肉
陆维	浙江慈溪市庵东中心医院眼科	中国中医眼科杂志	角膜缘干细胞移植治疗复发性翼状胬肉
陆豪	上海市宝山中心医院	眼外伤职业眼病杂志	翼状胬肉术中两种不同缝线对复发的影响
陆豪	中国上海市宝山区中心医院眼科	国际眼科杂志	激素诱发青光眼或高眼压的临床分析
陆金春	武警江苏总队南京医院检验科	临床眼科杂志	沙眼衣原体与沙眼的研究进展
陈丹	武汉市第一医院眼科	临床眼科杂志	翼状胬肉切除联合应用丝裂霉素 C 与自体结膜移植治疗翼状胬肉的 Meta 分析
陈丹	中国湖北省武汉市第一医院眼科	国际眼科杂志	丹参酮ⅡA对抑制翼状胬肉成纤维细胞增殖的研究
陈丹	中国湖北省武汉市第一医院眼科	国际眼科杂志	两种选择性环氧化酶-2抑制剂对翼状胬肉成纤维细胞生长影响的对比研究
陈丹	中国湖北省武汉市第一医院眼科	国际眼科杂志	银杏叶提取物对体外培养翼状胬肉成纤维细胞增殖的抑制作用
陈丽华	中国湖北省宜昌市中心人民医院视光学专科	国际眼科杂志	LASIK手术与翼状胬肉相互影响的探讨
陈丽娟	牡丹江医学院红旗医院一门诊眼科	眼外伤职业眼病杂志	羊膜移植治疗眼部烧伤并发症的疗效
陈丽娟	牡丹江医学院红旗医院一门诊眼2科	眼外伤职业眼病杂志	铁水烧伤继发假性翼状胬肉的治疗一例
陈丽娟	青州眼科医院潍坊医学院卫生统计学教研室	中国实用眼科杂志	青州市农村≥60岁居民眼疾病状况及未就诊影响因素分析
陈仕冰	广西南宁市第一人民医院	眼外伤职业眼病杂志	保存人羊膜在眼表疾病中的应用
陈伟	浙江省绍兴市人民医院眼科	眼科	翼状胬肉切除术中丝裂霉素C的应用
陈伟	浙江省绍兴市人民医院眼科	中国实用眼科杂志	翼状胬肉切除术中与术后应用丝裂霉素C的比较
陈佳音	中国广东汕头市中心医院眼科	国际眼科杂志	羊膜移植联合丝裂霉素术中应用预防翼状胬肉复发的前瞻性研究
陈健	浙江省湖州市第一人民医院眼科研究所	中华实验眼科杂志	翼状胬肉术后巩膜融解分析
陈健	浙江省湖州一院	眼科	自制口腔药膜治疗睑球粘连26例的初步观察
陈光约	三明市第二医院	眼外伤职业眼病杂志	自体角膜缘移植治疗翼状胬肉60例疗效观察
陈光约	福建省永安市三明第二医院眼科	中国实用眼科杂志	羊膜移植治疗翼状胬肉50例临床探讨
陈军	白银市第一人民医院眼科	眼外伤职业眼病杂志	新鲜羊膜移植治疗翼状胬肉临床观察
陈凌燕	深圳市儿童医院眼科	临床眼科杂志	FK506在实验性过敏性结膜炎局部免疫调控的作用
陈凌燕	深圳市儿童医院眼科	国际眼科杂志	FK506对实验性过敏性结膜炎细胞因子表达的影响
陈凤芬	陆川县人民医院	眼外伤职业眼病杂志	逆向剥离胬肉联合丝裂霉素C的观察
陈利荣	武汉科技大学附属天佑医院眼科	国际眼科杂志	翼状胬肉切除联合自体角膜缘干细胞移植与联合羊膜移植的疗效比较
陈利荣	武汉科技大学附属天佑医院	眼外伤职业眼病杂志	风湿病患者双眼翼状胬肉术后发生坏死性巩膜炎
陈剑	暨南大学附属第一医院	中国实用眼科杂志	新鲜羊膜移植治疗翼状胬肉的临床观察
陈剑	暨南大学医学院附属一医院眼科	眼外伤职业眼病杂志	羊膜联合自体角膜缘移植治疗复发性翼状胬肉
陈剑	暨南大学医学院眼科	眼外伤职业眼病杂志	翼状胬肉逆向切除联合羊膜移植的临床观察
陈剑	暨南大学附属第一医院眼科	中华实验眼科杂志	丝裂霉素C对翼状胬肉成纤维细胞膜通透性及超微结构的影响
陈剑	广州暨南大学附属第一医院眼科	中国实用眼科杂志	翼状胬肉的眼表改变
陈力迅	南京医科大学附属南京第一医院眼科	国际眼科杂志	翼状胬肉切除术前与术后角膜变化的研究
陈勇	诸暨市红十字医院	眼外伤职业眼病杂志	角膜缘干细胞移植与结膜瓣转位治疗翼状胬肉
陈勇明	南方医科大学附属顺德第一人民医院眼科	国际眼科杂志	舌下含服粉尘螨滴剂治疗季节性及常年性过敏性结膜炎
陈勇明	南方医科大学附属顺德第一人民医院耳鼻喉科	眼科	顺德地区过敏性结膜炎的变应原检测和治疗分析
陈勤	福州市第二医院眼科	中国实用眼科杂志	翼状胬肉的发生与角膜缘干细胞缺乏的病理研究
陈化冰	广西南宁市第一人民医院眼科	眼外伤职业眼病杂志	自体结膜角膜缘上皮移植术及保存人羊膜移植术治疗翼状胬肉疗效分析
陈华新	广州军区武汉总医院	眼外伤职业眼病杂志	自体角膜缘干细胞移植治疗复发性翼状胬肉
陈卓	中国四川省成都市第一人民医院眼科	国际眼科杂志	翼状胬肉切除联合角膜缘干细胞移植及术后药物治疗临床观察
陈博宇	中国人民解放军白求恩国际和平医院眼科	国际眼科杂志	儿童频繁瞬目病因分析
陈卫芳	广州医学院第二附属医院眼科	中国实用眼科杂志	螨脱敏治疗变应性结膜炎的观察
陈向东	中国湖南省浏阳市眼科医院眼科	国际眼科杂志	自体结膜移植术联合丝裂霉素C治疗复发性翼状胬肉
陈启城	汕头潮南民生医院眼科	国际眼科杂志	角膜缘干细胞移植治疗翼状胬肉合并结膜松弛症的观察
陈嘉宁	深圳市龙岗中心医院眼科	眼外伤职业眼病杂志	翼状胬肉手术中羊膜移植与自体角膜缘干细胞移植的效果对比
陈嘉莹	汕头大学医学院第一附属医院眼科	眼科	老年人带状疱疹性眼病的特点
陈嘉莹	汕头大学医学院第一附属医院眼科	中国眼耳鼻喉科杂志	曲安奈德上穹窿结膜下注射治疗重症春季角结膜炎
陈嘉莹	汕头大学医学院第一附属医院眼科广东汕头	眼科	干眼症误诊临床分析
陈嘉莹	汕头大学医学院一附院眼科	中国眼耳鼻喉科杂志	干眼症误诊原因分析及预防对策
陈士成	绍兴第四医院	眼外伤职业眼病杂志	结膜乳头切除加丝裂霉素C治疗春季角结膜炎
陈多军	湖北省应城市中医医院眼科	中国中医眼科杂志	改良翼状胬肉切除术的临床体会
陈奕烨	复旦大学附属眼耳鼻喉科医院眼科	中华眼底病杂志	经双目间接检眼镜激光光凝治疗严重早产儿视网膜病变
陈姚若	东莞市人民医院眼科	中华实验眼科杂志	干扰素a-2b与丝裂霉素C用于复发性胬肉的临床对比研究
陈娟奇	滨海县人民医院	眼外伤职业眼病杂志	翼状胬肉撕离联合不同角膜缘干细胞移植
陈媛媛	中国湖北省武汉市第十一医院眼科	国际眼科杂志	新鲜羊膜联合自体角膜缘移植治疗复发性翼状胬肉的疗效分析
陈子林	中国广东省惠州市中心人民医院眼科	国际眼科杂志	翼状胬肉切除联合带自体角膜缘干细胞的结膜移植治疗复发性翼状胬肉
陈宇	广州医学院荔湾医院眼科	国际眼科杂志	复发性与原发性翼状胬肉广泛切除联合羊膜移植治疗观察
陈宏	华中科技大学同济医学院附属协和医院眼科	中华眼科杂志	第15例——双眼疼痛并畏光流泪数日
陈宝文	江苏省沛县人民医院	中国实用眼科杂志	丝裂霉素C用于翼状胬肉自体角膜缘干细胞移植的临床分析
陈宝雄	海南省第三人民医院眼科	眼外伤职业眼病杂志	改良式翼状胬肉切除合并结膜转移术
陈家祺	中山大学中山眼科中心	中华眼科杂志	干眼患者115例的临床特点分析
陈家祺	中山大学眼表疾病研究中心	中华眼科杂志	提高我国常见眼表疾病的诊断与治疗水平
陈家祺	中山大学中山眼科中心	中国实用眼科杂志	FK506局部治疗顽固性春季角结膜炎
陈家祺	中山大学中山眼科中心	中华眼科杂志	急性结膜炎痊愈后泪膜的变化
陈家祺	中山大学中山眼科中心	中华眼科杂志	移植物抗宿主病相关的干眼病
陈家祺	中山大学中山眼科中心	中华实验眼科杂志	造血干细胞移植术后的眼部观察
陈家祺	中山大学中山眼科中心	中国实用眼科杂志	翼状胬肉切除对泪液功能的影响
陈家祺	中山大学眼科学国家重点实验室	中国实用眼科杂志	小牛血去蛋白提取物眼凝胶治疗角膜上皮缺损的多中心临床研究
陈家祺	中山大学中山眼科中心	中华眼科杂志	羊膜移植重建静止期眼结膜表面的远期疗效分析
陈家祺	中山大学中山眼科中心	中国实用眼科杂志	新生儿急性细菌性结膜炎细菌培养结果分析
陈小敏	华中科技大学同济医学院附属协和医院	中华眼视光学与视觉科学杂志	基质细胞衍生因子及其受体CXCR4在翼状胬肉的异常表达
陈峰	台州医院	眼外伤职业眼病杂志	翼状胬肉角膜缘干细胞移植与羊膜移植的比较
陈巧灵	河南省获嘉县中医院眼科	临床眼科杂志	252名农村电工沙眼发病情况调查
陈常乐	浙江省温州市第二人民医院	眼外伤职业眼病杂志	羊膜移植治疗翼状胬肉
陈建华	北京市眼科研究所微生物室	中华眼视光学与视觉科学杂志	44例真菌性角结膜炎患者真菌培养及药敏试验结果分析
陈建华	北京市眼科研究所	中国实用眼科杂志	Nd:YAG激光光凝治疗角膜浅表新生血管
陈建卓	解放军101医院眼科	中国中医眼科杂志	翼状胬肉及手术前后对角膜散光的影响
陈建卓	解放军101医院眼科	临床眼科杂志	自体角膜缘上皮移植联合贝复舒治疗翼状胬肉的疗效观察
陈建苏	暨南大学医学院眼科研究室	中华实验眼科杂志	翼状胬肉组织中胶原纤维的病理学改变
陈建英	浙江省长兴县人民医院眼科	中国眼耳鼻喉科杂志	两种术式治疗翼状胬肉的疗效对比
陈志	江苏省如皋市近视眼医院	中华眼视光学与视觉科学杂志	眼表麻醉致急性过敏性结膜炎1例
陈志喜	湖南省郴州医专附属医院眼科	中国中医眼科杂志	三种方法治疗翼状胬肉的疗效比较
陈志宏	中国广东省深圳市西乡人民医院眼科	国际眼科杂志	裂隙灯眼前段处理系统在眼科的临床应用
陈志生	天津市眼科医院	中国中医眼科杂志	针刺对Sjogren综合征患者泪液的影响
陈志钧	南京医科大学附属南京儿童医院眼科	中国眼耳鼻喉科杂志	原发性翼状胬肉760例术后复发情况分析
陈惠	海口市人民医院	眼外伤职业眼病杂志	自体角膜缘干细胞移植治疗翼状胬肉临床观察
陈惠康	苏州大学附属第一医院眼科	眼外伤职业眼病杂志	自体角膜缘移植羊膜移植治疗翼状胬肉
陈慷	中山大学中山眼科中心	中华实验眼科杂志	春季角膜结膜炎的免疫学发病机制研究
陈振谦	广州医学院第二附属医院眼科	中国实用眼科杂志	翼状胬肉根治手术预防复发的效果观察
陈振谦	广州医学院第二附属医院眼科	中华眼科杂志	翼状胬肉显微手术方法及其疗效观察
陈敏	武警广东边防总队医院眼科医疗中心	中国眼耳鼻喉科杂志	角膜缘干细胞移植治疗翼状胬肉
陈敏洁	复旦大学附属眼耳鼻喉科医院眼科	中国实用眼科杂志	富马酸酮替芬滴眼液治疗季节变应性结膜炎眼痒及结膜充血的疗效观察
陈文学	阆中市人民医院	眼外伤职业眼病杂志	结膜移植联合平阳霉素治疗复发性翼状胬肉
陈昌林	成都市第一人民医院	中国实用眼科杂志	软性角膜接触镜致巨乳头性结膜炎的治疗
陈明	郴州市第三人民医院	眼科	不同术式的翼状胬肉手术疗效分析
陈明智	广西南宁市第一人民医院	眼外伤职业眼病杂志	保存人羊膜在眼表疾病中的应用
陈星	河南南阳医专附院	眼外伤职业眼病杂志	新鲜羊膜移植治疗翼状胬肉的临床观察
陈映梅	福建省永安市三明第二医院眼科	中国实用眼科杂志	羊膜移植治疗翼状胬肉50例临床探讨
陈晓凯	河南省平顶山市第一人民医院眼科	临床眼科杂志	慢性睑缘炎的临床特点及误诊分析
陈晓明	四川大学华西医院眼科中心	国际眼科杂志	翼状胬肉切除、大范围Tenon囊切除联合丝裂霉素C治疗翼状胬肉的临床研究
陈晓明	四川I大学华西医院眼科中心	国际眼科杂志	翼状胬肉的流行病学研究现状
陈晓隆	中国医科大学盛京医院眼科	国际眼科杂志	自体结膜瓣移植治疗翼状胬肉的临床观察
陈景尧	厦门大学医学院眼科研究所	中华眼科杂志	双眼蚕蚀性角膜溃疡伴翼状胬肉一例
陈景武	青州眼科医院潍坊医学院卫生统计学教研室	中国实用眼科杂志	青州市农村≥60岁居民眼疾病状况及未就诊影响因素分析
陈梅	郑州市第二人民医院眼科	中国实用眼科杂志	阿托品联合双焦镜控制青少年轻中度近视疗效分析
陈梅	郑州市第二人民医院	眼外伤职业眼病杂志	翼状胬肉切除联合自体干细胞移植的临床研究
陈梦平	郑州市第二人民医院眼科	眼外伤职业眼病杂志	翼状胬肉不同手术方法的疗效比较
陈楠	中南大学湘雅三医院眼科	中国实用眼科杂志	XIAP和COX-2在翼状胬肉中的表达及其相关性研究
陈毅华	广东省中山市人民医院眼科	中华实验眼科杂志	脱水钝性剥离联合丝裂霉素C治疗翼状胬肉疗效观察
陈毓东	广东医学院附属医院眼科	眼科	半边旗二萜类化合物5F对人翼状胬肉成纤维细胞增殖周期和Ki-67表达的影响
陈毓东	广东医学院附属医院眼科	中华实验眼科杂志	丝裂霉素C抗人翼状胬肉成纤维细胞增殖的实验研究
陈毓东	广东医学院附属医院眼科	中国中医眼科杂志	半边旗二萜类化合物5F对人翼状胬肉成纤维细胞增殖的抑制作用
陈毓东	广东医学院附属医院眼科	中国中医眼科杂志	高三尖杉酯碱和血栓通对人翼状胬肉成纤维细胞周期性变化的影响
陈毓东	暨南大学第一临床学院眼科	中华实验眼科杂志	5F对人翼状胬肉成纤维细胞增生及Fas表达的调控
陈永勤	中国人民解放军第273医院眼科	中国中医眼科杂志	库尔勒市中老年人翼状胬肉的流行病学特点
陈永勤	中国人民解放军第273医院眼科，库尔勒	中国中医眼科杂志	巴音郭楞蒙古自治州5县市翼状胬肉患病率的调查
陈永勤	解放军273医院眼科	中国中医眼科杂志	浅层巩膜烧灼联合角膜缘干细胞移植治疗翼状胬肉
陈永明	湖南省郴州医专附属医院眼科	中国中医眼科杂志	三种方法治疗翼状胬肉的疗效比较
陈河	广西北海市合浦卫校附院眼科	眼外伤职业眼病杂志	新鲜人羊膜移植在重建眼表结构中的临床应用
陈洁	温州医学院眼视光学院	中国实用眼科杂志	高透氧性硬性角膜接触镜治疗屈光参差性弱视的疗效评估
陈洁	海军总医院眼科	中国实用眼科杂志	自体骨髓间充质干细胞移植改善重度眼表损伤临床观察
陈浙一	温州医学院附属眼视光医院	中华实验眼科杂志	Sj(o)gren综合征患者的角膜激光共焦显微镜活体观察
陈海娥	中国河北工程学院医学部附属医院眼科	国际眼科杂志	邯郸市区新生儿淋球菌性结膜炎发病的调查
陈淑娴	遵义医学院第五附属	国际眼科杂志	翼状胬肉上结膜反向移植联合生物羊膜治疗复发性翼状胬肉
陈滨	杭州市第一人民医院眼科	中国中医眼科杂志	自体带角膜缘干细胞的结膜瓣移位术治疗翼状胬肉
陈玉冰	广东省佛山市第一人民医院眼科	临床眼科杂志	急性结膜炎痊愈后泪膜功能的变化
陈玉林	深圳广东边防武警总队医院眼科	眼外伤职业眼病杂志	排多癌防治翼状胬肉术后复发疗效观察
陈琦	广西壮族自治区人民医院眼科	眼外伤职业眼病杂志	丝裂霉素C联合结膜徙盖术治疗复发性翼状胬肉
陈琦	广西壮族自治区人民医院眼科	眼外伤职业眼病杂志	色甘酸钠减少胬肉术中丝裂霉素影响的观察
陈琳	徐州医学院附属医院眼科	临床眼科杂志	自体角膜缘干细胞联合羊膜移植治疗复发性翼状胬肉
陈琳	徐州医学院附属医院眼科	国际眼科杂志	三种不同术式治疗复发性翼状胬肉的疗效观察
陈瑛	浙江省中医学院附属第三医院	眼外伤职业眼病杂志	自体角膜缘干细胞移植治疗翼状胬肉的观察
陈瑞华	福建医科大学解剖学系	中国实用眼科杂志	系统性红斑狼疮患者眼表损害及相关抗体检测
陈璐	河北省儿童医院眼科	中国实用眼科杂志	儿童睑缘耻阴虱感染一例
陈真真	通许县人民医院眼科	眼外伤职业眼病杂志	翼状胬肉的几种手术方式及其效果观察
陈祖基	河南省眼科研究所	中华实验眼科杂志	变应性结膜炎动物模型
陈祖基	河南省科研究所	中华实验眼科杂志	复方酮替芬滴眼剂对实验过敏性结膜炎的疗效观察
陈祖基	河南省眼科研究所	中华实验眼科杂志	变应性结膜炎药物治疗研究进展
陈福才	北京市平谷区医院眼科	眼科	多功能电离子治疗机治疗泪小点狭窄的临床观察
陈积中	安徽医科大学第一附属医院眼科	临床眼科杂志	隐翅虫性眼睑、结膜、角膜炎
陈立军	中国人民解放军第273医院眼科，库尔勒	中国中医眼科杂志	巴音郭楞蒙古自治州5县市翼状胬肉患病率的调查
陈素华	郸城县中医院	眼外伤职业眼病杂志	眶内非金属异物误诊原因分析及防止措施
陈素英	河南省直第三人民医院眼科	国际眼科杂志	旋转结膜瓣治疗翼状胬肉的远期疗效
陈红梅	中国四川省遂宁市中心医院眼科	国际眼科杂志	翼状胬肉不同术式治疗后1a内复发率的比较
陈细庆	龙海市第二医院眼科	中国实用眼科杂志	红眼病治疗用安乃近过敏致死一例
陈美霞	广东省佛山市南海区大沥医院眼科	中国实用眼科杂志	复发性翼状胬肉角膜缘干细胞移植远期疗效观察
陈翔熙	中山大学中山眼科中心眼科学国家重点实验室	中华眼科杂志	透明质酸钠对兔含苯扎氯铵溴莫尼定眼表毒性保护作用的研究
陈艳华	湖南省怀化医专附属医院暨怀化市三人民医院眼科	中国实用眼科杂志	原发性翼状胬肉的两种手术治疗的疗效比较
陈艳芳	湖南中医药大学第一附属医院眼科	中国中医眼科杂志	眼科围手术期的中医药治疗
陈荣家	复旦大学附属眼耳鼻喉科医院眼科	中国眼耳鼻喉科杂志	春季角结膜炎中角膜损害的研究进展
陈荣家	复旦大学附属眼耳鼻喉科医院	中华眼科杂志	眼部自然杀伤-T细胞淋巴瘤致角膜穿孔一例
陈萍珊	汕头大学医学院第一附属医院眼科	中国眼耳鼻喉科杂志	曲安奈德上穹窿结膜下注射治疗重症春季角结膜炎
陈蔚	上海市吴泾医院眼科	临床眼科杂志	自体角膜缘干细胞移植联合羊膜移植治疗复发性翼状胬肉
陈蔚	上海市吴泾医院眼科	临床眼科杂志	羊膜移植重建眼表的随访报告
陈蔚	温州医学院附属眼视光医院	中华实验眼科杂志	Sj(o)gren综合征患者的角膜激光共焦显微镜活体观察
陈裕峰	中国人民解放军第四○四医院眼科	中国眼耳鼻喉科杂志	自体角膜缘干细胞移植术治疗翼状胬肉80例
陈豪	省部共建国家重点实验室培育基地	中华实验眼科杂志	免疫刺激剂CpG ODN防治烟曲霉菌引起的变态反应性结膜炎的实验研究
陈跃真	福建泉州市儿童医院泉州北京同仁眼科中心	中国实用眼科杂志	翼状胬肉保留球结膜根治性切除联合应用丝裂霉素的疗效探讨
陈辉	四川省医学科学院四川省人民医院眼科	中国实用眼科杂志	四川省沙眼20年变迁
陈辉	四川省医学科学院四川省人民医院眼科	国际眼科杂志	四川省视力残疾状况分析
陈辉	四川省医学科学院四川省人民医院眼科	中国实用眼科杂志	近20年四川省主要视力残疾患病率变化分析
陈进波	广东省惠州市中心人民医院眼科	临床眼科杂志	微量曲安奈德在翼状胬肉术前的临床应用价值
陈逖	安徽医科大学附属医院眼科	眼外伤职业眼病杂志	角膜缘上皮联合羊膜移植治疗眼表疾病的研究
陈遐	天津市眼科医院	中华实验眼科杂志	青光眼术后巨大结膜囊肿一例
陈酉	北京大学第一医院眼科	中华眼科杂志	眼瘢痕性类天疱疮病例的回顾性分析
陈金华	浙江省中医学院附属第三医院	眼外伤职业眼病杂志	自体角膜缘干细胞移植治疗翼状胬肉的观察
陈金鹏	温州医学院附属眼视光医院	中华实验眼科杂志	Sj(o)gren综合征患者的角膜激光共焦显微镜活体观察
陈锋	中国人民武装警察部队江西总队医院眼科中心	中华眼科杂志	外伤致巩膜层间漏一例
陈锦昌	景德镇市第二人民医院眼科	国际眼科杂志	HTLV-1感染者的眼部临床表现
陈长征	武汉大学人民医院眼科	中华实验眼科杂志	翼状胬肉切除联合自体球结膜移植术中使用纤维蛋白胶和缝线有效性的随机对照试验的Meta分析
陈陟	绵阳市富临医院	眼外伤职业眼病杂志	无缝隙缝合带角膜缘干细胞结膜瓣术治疗翼状胬肉
陈雅琼	武汉艾格眼科医院	国际眼科杂志	武汉城区及周边农村翼状胬肉患病率的流行病学调查
陈雅琼	武汉艾格眼科医院眼表与眼整形科	国际眼科杂志	治疗性软性角膜接触镜在翼状胬肉手术中的应用和评价
陈雪年	南通大学附属海安医院眼科	眼外伤职业眼病杂志	复明工程中白内障合并翼状胬肉联合手术
陈雪梅	中山大学附属第一医院眼科	中华眼底病杂志	系统性红斑狼疮并发视网膜静脉阻塞的临床分析
陈雯	华中科技大学同济医学院附属协和医院眼科	中国眼耳鼻喉科杂志	美洛昔康对翼状胬肉成纤维细胞增殖抑制的实验研究
陈静	暨南大学附属深圳眼科中心	国际眼科杂志	两种药物治疗变态反应性结膜炎的疗效观察
陈静	中国人民解放军第161中心医院眼科	国际眼科杂志	角膜缘干细胞移植术治疗复发性翼状胬肉的疗效
陈鹏	郑州市第二人民医院眼科	临床眼科杂志	保存人羊膜和自体角膜缘移植术治疗复发性翼状胬肉临床观察
陈鹏	郑州市第二人民医院	中国实用眼科杂志	丝状角膜炎的临床治疗观察
陈鹏	郑州市眼科医院	中国中医眼科杂志	保存羊膜及丝裂霉素对翼状胬肉眼表的影响
陈鹏	郑州市第二人民医院	眼外伤职业眼病杂志	翼状胬肉切除联合自体干细胞移植的临床研究
陈鹏	郑州市第二人民医院眼科	眼外伤职业眼病杂志	翼状胬肉手术中无缝线自体角膜缘干细胞移植
陈龙山	中山大学中山眼科中心	中华眼科杂志	羊膜移植重建静止期眼结膜表面的远期疗效分析
陈龙山	中山大学眼表疾病研究中心	中国实用眼科杂志	过敏性结膜炎的临床特点
陈龙山	中山大学中山眼科中心	中国实用眼科杂志	FK506局部治疗顽固性春季角结膜炎
陈龙山	中山大学中山眼科中心	中华眼科杂志	干眼患者115例的临床特点分析
陳裕峰	中國山東威海市解放軍第404醫院眼科	国际眼科杂志	綜合治療翼狀胬肉
陶军	中国辽宁省沈阳市第四人民医院眼科	国际眼科杂志	糖皮质激素眼液在流行性角结膜炎治疗中的应用
陶凤莉	江苏省江阴市第二人民医院眼科	眼外伤职业眼病杂志	丝裂霉素C联合干细胞移植治疗翼状胬肉
陶勇	中国江苏省高邮市人民医院眼科	国际眼科杂志	自体结膜在翼状胬肉手术治疗中的美容效果观察
陶屹	复旦大学附属华山医院南汇分院眼科	国际眼科杂志	翼状胬肉切除改良术式的临床观察
陶屹	复旦大学附属华山医院南汇分院眼科	国际眼科杂志	翼状胬肉切除联合球结膜下生物羊膜移植的初步研究
陶明春	浙江省温州市第二人民医院	眼外伤职业眼病杂志	羊膜移植治疗翼状胬肉
陶沙	陕西省眼科研究所	国际眼科杂志	衣原体单克隆抗体胶体金法测定沙眼衣原体
陶海	武警总医院眼科泪器病中心	中华眼科杂志	先天性无泪症伴鳄鱼泪一例
陶海	武警总医院眼科	国际眼科杂志	泪道阻塞部位的分布特点及相关因素的初步研究
陶涛	大理州医院	眼外伤职业眼病杂志	羊膜移植联合丝裂霉素C防止翼状胬肉术后复发
陶涛	云南省大理州医院眼科	眼外伤职业眼病杂志	羊膜移植术治疗翼状胬肉临床分析
陶润平	暨南大学医学院附属第四医院眼科	临床眼科杂志	托百士滴眼液治疗眼表细菌性炎症的疗效观察
陶祥臣	山东省济南市中心医院眼科	中国实用眼科杂志	翼状胬肉切除联合羊膜移植术临床应用
陶祥臣	山东省济南市中心医院眼科	临床眼科杂志	两种方法保存羊膜联合自体角膜缘移植治疗复发性翼状胬肉
陶祥臣	山东大学附属济南市中心医院	临床眼科杂志	角膜干细胞移植在翼状胬肉显微手术中的应用
陶莎	西安市第一医院眼病研究室	中华实验眼科杂志	抗腺病毒3型单克隆抗体的制备及临床应用研究
陶黎明	安徽医科大学第二附属医院眼科	临床眼科杂志	10-0缝线和8-0可吸收缝线对翼状胬肉切除术后眼部舒适度的影响
陶黎明	安徽医科大学第一附属医院眼科	临床眼科杂志	单剂量丝裂霉素C局部注射对翼状胬肉组织中血管和成纤维细胞的影响
雷先明	绵阳万江眼科医院	国际眼科杂志	中药内外合治治疗流行性出血性结膜炎疗效观察
雷帅臣	广东省惠东县人民医院眼科	临床眼科杂志	三种不同术式翼状胬肉切除术的临床对比观察
雷方	郑州大学第四附属医院	眼外伤职业眼病杂志	自体结膜移植治疗翼状胬肉的临床探讨
雷春涛	四川省医学科学院四川省人民医院眼科	中国实用眼科杂志	近20年四川省主要视力残疾患病率变化分析
雷春涛	四川省医学科学院四川省人民医院眼科	中国实用眼科杂志	四川省沙眼20年变迁
雷春涛	四川省医学科学院四川省人民医院眼科	国际眼科杂志	四川省视力残疾状况分析
雷春燕	，中國新疆獨山子石化總廠醫院眼科	国际眼科杂志	自體角膜緣幹細胞球結膜移植治療翼狀胬肉
雷晓琴	中国陕西省西安市第四医院眼科	国际眼科杂志	自体角膜缘上皮移植治疗翼状胬肉52例
雷流星	郴州市第三人民医院	眼科	不同术式的翼状胬肉手术疗效分析
雷海云	中国广西壮族自治区横县人民医院眼科	国际眼科杂志	逆向方法联合丝裂霉素结膜瓣转移术治疗翼状胬肉
雷海珠	武汉爱尔眼科医院	中华实验眼科杂志	染料木黄酮对翼状胬肉成纤维细胞增殖的抑制作用
雷澄	武汉钢铁集团公司总医院眼科	国际眼科杂志	翼状胬肉逆行切除术1例
雷达威	哈尔滨爱尔眼科医院	临床眼科杂志	翼状胬肉面积与角膜散光关系的分析研究
雷进民	南宁市红十字会医院眼科	眼外伤职业眼病杂志	羊膜移植治疗翼状胬肉
霍丽君	中山大学附属第一医院眼科	中华眼底病杂志	系统性红斑狼疮并发视网膜静脉阻塞的临床分析
霍国庆	中国新疆维吾尔自治区乌鲁木齐市	国际眼科杂志	春季卡他性结膜炎患者泪液β2微球蛋白的测定及意义
霍晶	天津公安医院	眼外伤职业眼病杂志	自体结膜及角膜缘干细胞移植治疗翼状胬肉
霍朝魁	四川大学华西医院眼科	国际眼科杂志	成都市767例干部体检眼科疾病构成分析
霍永军	安阳市眼科医院	眼外伤职业眼病杂志	羊膜移植在翼状胬肉手术中的应用
霍灿明	广州市白云区红十字医院	中华实验眼科杂志	翼状胬肉术后角膜穿孔二例
霍灿明	广州市白云区红十字会医院五官科	临床眼科杂志	翼状胬肉术后角膜穿孔2例
霍鸣	三峡大学第一临床医学院湖北省宜昌市中心人民医院眼科	国际眼科杂志	改良式角膜缘干细胞移植治疗原发性翼状胬肉的手术体会
霍鸣	湖北省宜昌市中心人民医院	中国实用眼科杂志	结膜及睑板淀粉样变性一例
靳扬扬	北京煤炭总医院眼科	临床眼科杂志	120例儿童异常瞬目症的临床分析
靳瑛	北京大学第三医院北京大学眼科中心	中华眼科杂志	慢性结膜炎患者泪液中腺病毒与单纯疱疹病毒的检测
靳雷	中国江苏省徐州市第一人民医院眼科	国际眼科杂志	不同术式治疗翼状胬肉的疗效观察
靳雷	中国江苏省徐州市第一人民医院眼科徐州市眼病防治研究所	国际眼科杂志	两种结膜植片缝合法对翼状胬肉手术的影响
靳	三峡大学第一临床医学院湖北省宜昌市中心人民医院眼科	国际眼科杂志	改良式角膜缘干细胞移植治疗原发性翼状胬肉的手术体会
韦东	中国中医科学院西苑医院眼科	中国中医眼科杂志	干眼误诊的临床因素分析
韦丽娇	广西中医药大学附属瑞康医院眼科	临床眼科杂志	准分子激光治疗早期复发性翼状胬肉的临床观察
韦思广	钦州市第二人民医院	眼外伤职业眼病杂志	羊膜移植治疗难治性眼表疾病的临床效果
韦敏	中国河北省邯郸市眼科医院	国际眼科杂志	翼状胬肉发病机制及治疗研究进展
韦斌	克拉玛依市中心医院眼科	中国实用眼科杂志	准分子激光角膜上皮瓣下磨镶术治疗角膜浅层病变观察
韦玉玲	中国广西壮族自治区柳州市第四人民医院眼科	国际眼科杂志	丝裂霉素C联合自体角膜缘干细胞治疗复发性翼状胬肉的疗效分析
韦玮	广东省佛山市南海区大沥医院眼科	中国实用眼科杂志	复发性翼状胬肉角膜缘干细胞移植远期疗效观察
韦福依	广西百色地区人民医院	眼外伤职业眼病杂志	自身角膜缘结膜移植治疗翼状胬肉
韩东	山东莱芜市莱城区人民医院	临床眼科杂志	淋菌性结膜炎合并衣原体感染分析
韩丽川	中国广东省深圳市西乡人民医院眼科	国际眼科杂志	裂隙灯眼前段处理系统在眼科的临床应用
韩二营	中国河南省濮阳市眼科医院临床科	国际眼科杂志	自体带球结膜瓣的角膜缘干细胞移植治疗翼状胬肉
韩冬	上海交通大学医学院附属第九人民医院整形外科	中华眼视光学与视觉科学杂志	逆行切除联合自体带蒂球结膜瓣移植治疗翼状胬肉
韩冬梅	安徽省淮南市晨光眼科医院	临床眼科杂志	自体角膜缘干细胞移植联合准分子激光治疗性角膜切削术治疗翼状胬肉的临床观察
韩冰	中国广东省深圳市眼科医院小儿眼科	国际眼科杂志	盐酸氮卓斯汀滴眼液治疗儿童变态反应性结膜炎的疗效
韩冰	暨南大学附属深圳眼科中心	国际眼科杂志	两种药物治疗变态反应性结膜炎的疗效观察
韩勇娟	复旦大学附属华山医院南汇分院眼科	国际眼科杂志	翼状胬肉切除联合球结膜下生物羊膜移植的初步研究
韩勇娟	复旦大学附属华山医院南汇分院眼科	国际眼科杂志	翼状胬肉切除改良术式的临床观察
韩宝军	安阳市眼科医院	眼外伤职业眼病杂志	双向角膜缘干细胞移植治疗翼状胬肉
韩文杰	东营市人民医院	眼外伤职业眼病杂志	纤维蛋白胶在翼状胬肉切除联合自体角膜缘干细胞移植术中的应用研究
韩文杰	山东省东营市人民医院	中国中医眼科杂志	翼状胬肉钝性剥离联合纤维蛋白胶固定自体角膜缘干细胞移植术的临床应用
韩新继	安徽省淮南市晨光眼科医院	临床眼科杂志	自体角膜缘干细胞移植联合准分子激光治疗性角膜切削术治疗翼状胬肉的临床观察
韩晓丽	福建医科大学附属第一医院眼科	国际眼科杂志	干眼症83例病因诊断与误诊分析
韩曙霞	天津市津南区咸水沽医院眼科	中国实用眼科杂志	天津市大港区中老年人翼状胬肉的流行病学调查
韩有兰	青海红十字医院	眼外伤职业眼病杂志	保存人羊膜移植治疗翼状胬肉临床观察
韩梅	天津市眼科医院	眼外伤职业眼病杂志	翼状胬肉术中应用丝裂霉素C的临床观察
韩梅	天津医科大学眼科临床学院、天津市眼科医院	中华眼底病杂志	后巩膜炎继发急性浅前房一例
韩真	中国陕西省宝鸡市中医医院眼科	国际眼科杂志	翼状胬肉病因和治疗与复发干预的临床研究进展
韩真真	温州医学院附属第二医院眼科	临床眼科杂志	翼状胬肉术后的角膜地形图改变
韩竹梅	上海中医药大学附属普陀医院眼科	国际眼科杂志	结膜松弛症球结膜成纤维细胞培养的研究
韩芳	中国云南省第一人民医院眼科	国际眼科杂志	广泛切除联合术后丝裂霉素C滴眼治疗翼状胬肉
韩莉	山东潍坊医学院第三附属医院眼科	中国实用眼科杂志	自体角膜缘干细胞移植治疗翼状胬肉的疗效分析
韩雷	河南省眼科研究所	临床眼科杂志	羊膜移植联合曲安奈德治疗复发性翼状胬肉的临床观察
项广珍	承德医学院附属医院眼科	中国斜视与小儿眼科杂志	42例新生儿淋菌性结膜炎治疗
项广珍	承德医学院附属医院	眼科	干眼症患病因素的临床分析
项振扬	浙江省台州医院路桥院区眼科	中国实用眼科杂志	角膜缘干细胞移植术和羊膜移植术治疗复发性翼状胬肉的比较
项敏泓	上海中医药大学附属普陀医院眼科	中华眼科杂志	睑板腺功能异常
项敏泓	上海中医药大学附属普陀医院眼科	国际眼科杂志	结膜松弛症球结膜成纤维细胞培养的研究
项敏泓	上海中医药大学附属普陀医院眼科	国际眼科杂志	利用OCT观察流行性出血性结膜炎的临床研究
项道满	广州市妇女儿童医疗中心眼科	中国斜视与小儿眼科杂志	104例儿童异常瞬目临床诊疗分析
项道满	广州市妇女儿童医疗中心眼科	中国实用眼科杂志	基层医院早产儿视网膜病变筛查方式及筛查标准探讨
顼晓琳	首都医科大学北京同仁眼科中心	中华眼科杂志	结膜鳞状细胞癌侵犯眼球内一例
顾丽萍	中国江苏省苏州市眼视光医院眼科	国际眼科杂志	酒精浸泡剥离法在翼状胬肉手术中的疗效观察
顾倬	兰州大学第二临床医学院	国际眼科杂志	甘肃省农村小学生沙眼快速评估的初步调查报告
顾勇	无锡第三人民医院	中华眼视光学与视觉科学杂志	三种衣原体感染与人类角膜结膜炎的关系
顾国焕	上海市奉贤区中医院	眼外伤职业眼病杂志	治疗翼状胬肉的两种结膜移行遮盖法对比研究
顾扬顺	浙江大学医学院附属第一医院眼科	中国中医眼科杂志	翼状胬肉患者手术前后泪膜功能的变化
顾莉莉	安徽省马鞍山市马钢医院眼科	临床眼科杂志	羊膜移植治疗翼状胬肉临床疗效观察
顾迎霞	湖北省中山医院眼科	国际眼科杂志	夜戴型角膜塑形镜矫治儿童屈光参差疗效分析
颜为礼	兰州市第一人民医院	中国中医眼科杂志	针灸治疗目劄
颜华	天津医科大学总医院眼科	中华眼视光学与视觉科学杂志	丝裂霉素C局部贴敷辅助自体角膜缘结膜移植术治疗翼状胬肉
颜建华	中山大学中山眼科中心	中国实用眼科杂志	上穹窿结膜表皮样囊肿的手术治疗
颜海平	广东省韶关市第一人民医院眼科	临床眼科杂志	新鲜羊膜移植治疗复发性翼状胬肉
颜海平	韶关市第一人民医院	眼外伤职业眼病杂志	羊膜联合自体角膜缘干细胞移植治疗翼状胬肉
颜美荣	解放军第一六三医院眼科	中华眼科杂志	翼状胬肉中诱导一氧化氮合酶与FⅧ相关抗原表达的研究
颜美荣	解放军第一六三医院眼科	中国实用眼科杂志	FⅧ-RAg VEGF在翼状胬肉中表达和微血管密度检测及其意义
颜舫	南京市玄武医院眼科	临床眼科杂志	自体结膜角膜缘移植与自体结膜移植治疗复发性翼状胬肉
饶志波	中国广东省广州市第一人民医院眼科	国际眼科杂志	亲水性软性角膜接触镜在眼表疾病治疗中的疗效观察
馮桂平	中國遼宁大連市第二人民醫院眼科	国际眼科杂志	自體角膜缘上皮移植聯合5一氟脲嘧啶治瘵翼狀胬肉的臨床觀察
马丽华	广西柳州市眼科医院	临床眼科杂志	中低温保存羊膜在复杂眼表疾病中的应用
马元孝	山东省聊城市光明眼科医院屈光科	中国实用眼科杂志	PRK术后角膜上皮糜烂、剥脱并流行性角结膜炎
马克明	河南省新乡市第一人民医院眼科	眼外伤职业眼病杂志	翼状胬肉术联合药物应用的临床观察
马凤丽	双鸭山煤炭总医院	眼外伤职业眼病杂志	人羊膜移植治疗眼表疾病19例临床分析
马刚	中国人民解放军石家庄医学高等专科学校	中国中医眼科杂志	柳叶液抑制肠病毒70型的体外实验研究
马利波	沈阳市爱尔眼视光医院	中国实用眼科杂志	自体角膜缘干细胞移植联合丝裂霉素C治疗翼状胬肉疗效观察
马卫东	南通医学院第二附属医院眼科江苏南通	眼科	低温保存人羊膜移植在重建眼表结构中的临床应用
马卫东	南通医学院第二附属医院眼科	眼科	单层或多层羊膜移植治疗眼表疾病
马善英	浙江省平湖市眼科医院	眼外伤职业眼病杂志	角膜缘干细胞移植治疗翼状胬肉
马国政	山东省威海市立医院眼科	中国眼耳鼻喉科杂志	新生儿泪囊炎的按摩治疗法
马子伟	湖州师范学院附属第一医院眼科	国际眼科杂志	翼状胬肉术后角膜屈光状态稳定时间的临床观察
马宝林	湖南省人民医院眼科	中国中医眼科杂志	白内障术前清洁结膜囊方法的比较
马小鹰	上海市公利医院眼科	临床眼科杂志	表面麻醉在眼科手术中的应用
马广民	临颍县人民医院	眼外伤职业眼病杂志	新鲜羊膜移植治疗复发性翼状胬肉的效果观察
马广民	临颍县人民医院眼科	眼外伤职业眼病杂志	丝裂霉素C、氟羟强的松龙联合干细胞移植治疗翼状胬肉疗效观察
马建兴	美国南卡州医科大学眼科研究所	中华实验眼科杂志	PEDF和VEGF在翼状胬肉组织中的不平衡表达
马建兴	中国浙江省金华市中心医院眼科	国际眼科杂志	翼状胬肉组织PEDF和VEGF的不平衡表达
马建华	山东省临邑县人民医院眼科中心	眼外伤职业眼病杂志	角膜缘干细胞移植治疗复发性翼状胬肉
马惠玲	甘肃省定西市第二人民医院眼科	眼外伤职业眼病杂志	翼状胬肉自体角膜缘干细胞移植手术
马挺	中国陕西省西安市眼科医院	国际眼科杂志	翼状胬肉切除联合丝裂霉素C术后巩膜溶解的分析
马效功	兰州军区乌鲁木齐总医院眼科	中华实验眼科杂志	倍诺喜滴眼液致双眼严重角膜损害一例
马新爱	郑州人民医院卓美眼科	眼外伤职业眼病杂志	翼状胬肉术后巩膜并发症的临床分析及治疗观察
马晓爽	辽宁医学院附属第一医院眼科	国际眼科杂志	羊膜移植和自体角膜缘干细胞移植治疗翼状胬肉
马晓程	中国内蒙古自治区呼和浩特市	国际眼科杂志	沙眼诊断和治疗的研究进展
马晓芸	上海市卢湾区疾病预防控制中心	中华眼视光学与视觉科学杂志	逆行切除联合自体带蒂球结膜瓣移植治疗翼状胬肉
马景学	河北医科大学第二医院眼科	中国中医眼科杂志	姜黄素的药理作用及其在眼科的应用研究进展
马景燕	固始县中医院	眼外伤职业眼病杂志	三联术治疗翼状胬肉效果观察
马林	天津医科大学眼科临床学院	中华实验眼科杂志	儿童急性结膜炎后长期干眼一例
马洪梅	中国海洋石油总医院眼科	国际眼科杂志	老年性上睑皮肤松垂及睑内翻矫正术
马洪梅	海洋石油总医院眼科	国际眼科杂志	可吸收缝线固定移位带角膜缘干细胞结膜瓣术治疗原发性翼状胬肉
马润清	中国宁夏回族自治区银川市	国际眼科杂志	宁夏地区翼状胬肉患病率的流行病学调查
马润清	中国宁夏回族自治区银川市	国际眼科杂志	宁夏地区沙眼患病率流行病学调查
马淑玲	武城县中医院	眼外伤职业眼病杂志	复发性翼状胬肉的综合治疗及临床观察
马烈	中国江苏省苏州市眼视光医院眼科	国际眼科杂志	酒精浸泡剥离法在翼状胬肉手术中的疗效观察
马玉胜	山东潍坊医学院第三附属医院眼科	中国实用眼科杂志	自体角膜缘干细胞移植治疗翼状胬肉的疗效分析
马秀艳	新疆生产建设兵团总医院	眼外伤职业眼病杂志	巩膜表层血管烧灼联合推进式结膜移植治疗翼状胬肉
马科	首都医科大学附属同仁医院眼科中心	中国中医眼科杂志	珍芪滴眼液治疗慢性结膜炎的实验研究
马科	首都医科大学附属北京同仁医院	眼科	北京市城乡限定人群白内障手术负荷量及术后视力评价
马科	首都医科大学北京同仁眼科中心	中华眼科杂志	北京特定地区翼状胬肉患病率的流行病学调查
马立威	中国医科大学附属第四医院眼科	中国实用眼科杂志	翼状胬肉切除加相邻带干细胞自体结膜转位术疗效观察
马立威	中国医科大学附属第四医院眼科	国际眼科杂志	两种不同术式治疗翼状胬肉的疗效比较
马群	华中科技大学同济医学院附属协和医院眼科	临床眼科杂志	儿童过敏性结膜炎和过敏性鼻炎的关系
马翔	广西医科大学第五附属医院	国际眼科杂志	翼状胬肉术后角巩膜溶解6眼
马茹来	内蒙古科技大学第一附属医院眼科	中华实验眼科杂志	内蒙古赤峰市克什克腾旗中小学生沙眼流行病学调查
马莉	中国宁夏回族自治区银川市	国际眼科杂志	宁夏地区翼状胬肉患病率的流行病学调查
马莉	中国宁夏回族自治区银川市	国际眼科杂志	宁夏地区沙眼患病率流行病学调查
马莲芳	中国陕西省榆林市星元医院眼科	国际眼科杂志	干眼症误诊的临床分析
马雄雄	延安大学附属医院眼科	国际眼科杂志	双氯芬酸钠滴眼液在翼状胬肉术后的应用
马雪花	伊犁哈萨克自治州中医医院中西医眼病中心	中国中医眼科杂志	自体角膜缘干细胞结膜移植治疗翼状胬肉
马骎	山西省眼科医院	临床眼科杂志	瞬目频繁患儿病因分析
骆天真	广东省人民医院血液科	中华眼科杂志	移植物抗宿主病相关的干眼病
骆天真	广东省人民医院血液科	中华实验眼科杂志	造血干细胞移植术后的眼部观察
骆荣江	中山大学第二附属医院眼科	中国实用眼科杂志	翼状胬肉切除结膜移植联合术后90Sr照射的疗效观察
骆非	首都医科大学同仁医院眼科中心	中国实用眼科杂志	自体骨髓间充质干细胞移植改善重度眼表损伤临床观察
高云	云南省职业病防治研究所	眼外伤职业眼病杂志	接触五硫化二磷工人眼部影响的调查
高亚林	许昌市中心医院	眼外伤职业眼病杂志	角膜缘上皮移植联合丝裂霉素C治疗翼状胬肉
高付林	解放军306医院眼科	眼科	不含苯扎氯铵的抗青光眼滴眼液疗效及安全性的Meta分析
高伟	内蒙古科技大学第一附属医院眼科	中华实验眼科杂志	内蒙古赤峰市克什克腾旗中小学生沙眼流行病学调查
高佩媛	兰州市第一人民医院	中国中医眼科杂志	针灸治疗目劄
高健生	中国中医科学院眼科医院	中国中医眼科杂志	川椒方治疗过敏性结膜炎的临床观察
高健生	中国中医科学院眼科医院	中国中医眼科杂志	过敏性结膜炎的治疗研究进展
高健生	中国中医研究院眼科医院	中国中医眼科杂志	金珠滴眼液治疗慢性结膜炎的临床观察
高军伟	汝阳县人民医院	眼外伤职业眼病杂志	自体结膜角膜缘干细胞移植治疗翼状胬肉
高利梅	中国陕西省榆林市星元医院眼科	国际眼科杂志	干眼症误诊的临床分析
高华	山东省眼科研究所	中华眼视光学与视觉科学杂志	联合或不联合板层角膜移植的结膜瓣移植治疗巩膜坏死
高夕宁	山东省威海市文登中心医院眼科	中国眼耳鼻喉科杂志	文登沿海乡镇中老年翼状胬肉的流行病学特点
高婧	滨州医学院眼科学教研室	临床眼科杂志	角膜磨削联合角膜缘干细胞移植术治疗翼状胬肉疗效观察
高媛	中国湖北省武汉市第一医院眼科	国际眼科杂志	丹参酮ⅡA对抑制翼状胬肉成纤维细胞增殖的研究
高媛	华中科技大学同济医学院附属协和医院眼科	中国眼耳鼻喉科杂志	美洛昔康对翼状胬肉成纤维细胞增殖抑制的实验研究
高媛	中国湖北省武汉市第一医院眼科	国际眼科杂志	两种选择性环氧化酶-2抑制剂对翼状胬肉成纤维细胞生长影响的对比研究
高媛	武汉市第一医院眼科	中华实验眼科杂志	翼状胬肉中人乳头瘤病毒及单纯疱疹病毒的检测
高媛	华中科技大学同济医学院附属协和医院眼科	中华眼科杂志	翼状胬肉中环氧合酶2的表达及其相关研究
高宗银	中国广东省广州市第一人民医院眼科	国际眼科杂志	亲水性软性角膜接触镜在眼表疾病治疗中的疗效观察
高岩	辽宁省本溪市中心医院眼科	中国眼耳鼻喉科杂志	羊膜移植治疗翼状胬肉的临床观察
高延庆	郑州市第五人民医院眼科	眼外伤职业眼病杂志	羊膜移植治疗巨大乳头性春季结膜炎
高建民	天津医科大学眼科临床学院、天津市眼科医院	中华眼底病杂志	后巩膜炎继发急性浅前房一例
高慕洁	中国广东省茂名市人民医院眼科	国际眼科杂志	带角膜缘干细胞自体结膜瓣移植术治疗翼状胬肉
高慧筠	北京中医药大学东直门医院眼科	中国中医眼科杂志	自体结膜角膜缘干细胞移植术治疗翼状胬肉的临床观察
高昌卫	宁波市医疗中心李惠利医院	临床眼科杂志	宁波地区沙眼患病率调查
高晓云	郑州铁路局医疗保险中心	眼外伤职业眼病杂志	初发翼状胬肉的手术治疗
高晓唯	中国人民解放军第474医院眼科医院	国际眼科杂志	头孢曲松钠治疗新生儿淋球菌性结膜炎
高景秀	北京中医药大学附属东直门医院眼科	中国中医眼科杂志	退赤止痒液治疗春季结膜炎
高波	武汉科技大学附属天佑医院眼科	国际眼科杂志	翼状胬肉切除联合自体角膜缘干细胞移植与联合羊膜移植的疗效比较
高烨	江苏省江阴市第二人民医院眼科	眼外伤职业眼病杂志	丝裂霉素C联合干细胞移植治疗翼状胬肉
高玉宝	天津市第四中心医院眼科	中国实用眼科杂志	自体角膜上皮移植治疗翼状胬肉
高玉萍	辽宁抚顺眼病医院	中国实用眼科杂志	冻干人羊膜治疗翼状胬肉的临床观察
高玫蕊	延安大学附属医院眼科	国际眼科杂志	复发性翼状胬肉切除联合自体角膜缘上皮移植的疗效分析
高红	济南施尔明眼科医院	眼外伤职业眼病杂志	自体角膜缘干细胞移植术治疗翼状胬肉
高莉莉	内蒙古医学院第三附属医院眼科	临床眼科杂志	人羊膜移植治疗翼状胬肉的临床观察
高雪辉	陕西省宝鸡市解放军第三医院眼科	中华眼视光学与视觉科学杂志	眼毛囊异位症合并睑板腺囊肿1例
高飞	首都医科大学北京同仁眼科中心	中华眼科杂志	结膜鳞状细胞癌侵犯眼球内一例
魏丽歌	中国陕西省宝鸡市中医医院眼科	国际眼科杂志	翼状胬肉病因和治疗与复发干预的临床研究进展
魏亚明	解放军第25医院眼科	眼外伤职业眼病杂志	翼状胬肉术后并发症三例报告
魏俊	山东省烟台市烟台山医院眼科	中国实用眼科杂志	角膜缘干细胞移植治疗翼状胬肉
魏厚仁	同济医科大学附属协和医院眼科	眼科	干扰素α-2b对结膜下成纤维细胞生长形态的影响
魏厚仁	华中科技大学医学院附属协和医院眼科	中华眼科杂志	门诊重症沙眼患者的有关因素调查
魏厚仁	同济医科大学附属协和医院眼科	中华实验眼科杂志	春季结膜炎患者血清中的IL-1β及IL-8
魏敏	四川省医学科学院四川省人民医院眼科	中国实用眼科杂志	四川省沙眼20年变迁
魏敏	四川省医学科学院四川省人民医院眼科	国际眼科杂志	四川省视力残疾状况分析
魏敏	四川省医学科学院四川省人民医院眼科	中国实用眼科杂志	近20年四川省主要视力残疾患病率变化分析
魏文斌	首都医科大学附属北京同仁医院眼科中心	国际眼科杂志	精神压力与心因性结膜炎58例的心理治疗
魏来	北华大学附属医院眼科	中华眼底病杂志	双眼后巩膜炎一例
魏淑蓉	山东省青岛市青岛疗养院眼科	国际眼科杂志	自体角膜缘上皮移植和羊膜移植治疗翼状胬肉107例
魏滃	中国广东省东莞市企石医院眼科	国际眼科杂志	不同术式治疗翼状胬肉的疗效观察
魏瑞华	天津医科大学眼科中心	国际眼科杂志	云南省怒江州贡山县翼状胬肉的流行病学调查
魏瑞华	天津医科大学眼科医院	国际眼科杂志	纤维蛋白胶在翼状胬肉切除联合自体角膜缘干细胞移植术中的临床效果
魏瑞华	天津医科大学眼科研究所	国际眼科杂志	表面麻醉下翼状胬肉手术中应用纤维蛋白胶的效果
魏税利	第二军医大学长征医院眼科	中国实用眼科杂志	自体角膜缘上皮移植治疗复发性翼状胬肉
魏蔚	襄樊市襄阳医院	眼外伤职业眼病杂志	翼状胬肉术后并发植入性结膜囊肿三例报告
魏锐利	第二军医大学附属长征医院眼科	临床眼科杂志	结膜瓣转移与羊膜移植治疗复发性翼状胬肉的疗效对比分析
鲁倩倩	通许县人民医院眼科	眼外伤职业眼病杂志	翼状胬肉的几种手术方式及其效果观察
鲁小中	北京武警总医院北京	眼科	后巩膜炎3例报告
鲁建华	兰州大学第二医院眼科	国际眼科杂志	甘肃舟曲县藏汉族小学生干眼症的流行病学调查
鲁铭	武汉市第一医院眼科	中华实验眼科杂志	翼状胬肉中人乳头瘤病毒及单纯疱疹病毒的检测
鲁铭	武汉市第一医院眼科	中国眼耳鼻喉科杂志	翼状胬肉切除术联合丝裂霉素与角膜缘上皮移植的疗效观察
鲁铭	中国湖北省武汉市第一医院眼科	国际眼科杂志	Toric人工晶状体植入矫正特殊角膜散光的疗效观察
鲁静	成都爱尔眼科医院	国际眼科杂志	复发性翼状胬肉33眼手术疗效观察
鲍勇	舒城县城关医院中医眼科	中国中医眼科杂志	养血祛风散和炎敏宁治疗春季结膜炎疗效观察
鲍学英	无锡市第二人民医院眼科	中国实用眼科杂志	肉眼下翼状胬肉切除联合自体角膜缘干细胞移植临床分析
鲍捷	四川大学华西医院眼科中心	国际眼科杂志	翼状胬肉切除、大范围Tenon囊切除联合丝裂霉素C治疗翼状胬肉的临床研究
鲍道平	舒城县城关医院中医眼科	中国中医眼科杂志	养血祛风散和炎敏宁治疗春季结膜炎疗效观察
鹿秀海	山东省眼科研究所	中华实验眼科杂志	丝状角膜炎角膜丝状物构成分析
麻南	解放军306医院眼科	眼科	不含苯扎氯铵的抗青光眼滴眼液疗效及安全性的Meta分析
麻张伟	台州市椒江眼科医院	眼外伤职业眼病杂志	翼状胬肉逆向切除联合羊膜移植的临床观察
黄一涛	暨南大学附属深圳市眼科医院	国际眼科杂志	泪点炎的临床观察研究
黄一飞	解放军总医院眼科	眼科	人工角膜植入术
黄一飞	解放军总医院眼科	中华眼科杂志	波士顿人工角膜临床应用及其进展
黄丽娜	暨南大学医学院深圳眼科中心、深圳市眼科医院	国际眼科杂志	翼状胬肉成纤维细胞中COX-2的表达及其抑制剂的实验研究
黄丽娜	深圳市眼科医院	中华实验眼科杂志	翼状胬肉组织中环氧化酶-2及p21-ras的表达研究
黄丽娜	深圳市眼科医院	临床眼科杂志	干眼对白内障手术的影响及其治疗方法
黄丽娜	暨南大学医学院附属深圳眼科中心	中华实验眼科杂志	翼状胬肉组织中胶原纤维的病理学改变
黄丽群	广西百色地区人民医院	眼外伤职业眼病杂志	自身角膜缘结膜移植治疗翼状胬肉
黄丽萍	广西北海市合浦卫校附院眼科	眼外伤职业眼病杂志	新鲜人羊膜移植在重建眼表结构中的临床应用
黄伟	泰兴市人民医院	眼外伤职业眼病杂志	生物羊膜移植治疗复发性翼状胬肉临床观察
黄伟奇	广东医学院附属医院眼科	国际眼科杂志	翼状胬肉组织中Bcl-2和ICAM-1的表达
黄健	九江医学高等专科学校附属医院	眼外伤职业眼病杂志	翼状胬肉切除术后出血一例
黄先进	暨南大学医学院深圳眼科中心深圳市眼科医院	国际眼科杂志	翼状胬肉眼使用电脑验光和视网膜检影测定散光的对比研究
黄勤	中山市小榄人民医院眼科	中国中医眼科杂志	平阳霉素治疗早期复发性翼状胬肉疗效观察
黄勤	中山市小榄人民医院眼科	中国中医眼科杂志	自体角膜缘干细胞移植联合丝裂霉素C治疗翼状胬肉的临床研究
黄厚斌	中国人民解放军总医院眼科	中国眼耳鼻喉科杂志	翼状胬肉的现代微创显微手术治疗
黄培根	广东医学院病理学教研室	中国中医眼科杂志	高三尖杉酯碱和血栓通对人翼状胬肉成纤维细胞周期性变化的影响
黄奕霞	中国广东汕头市中心医院眼科	国际眼科杂志	羊膜移植联合丝裂霉素术中应用预防翼状胬肉复发的前瞻性研究
黄幕贞	遵义医学院第五附属	国际眼科杂志	翼状胬肉上结膜反向移植联合生物羊膜治疗复发性翼状胬肉
黄应桂	广东医学院附属医院病理科	中华实验眼科杂志	PCNA和bcl-2在翼状胬肉成纤维细胞中的表达及蝮蛇抗栓酶的影响
黄志	江西省抚州公费医疗门诊部	中华眼科杂志	眼科手术后斜视和复视的临床分析
黄志强	安徽省黄山市解放军532医院眼科	中国实用眼科杂志	乙醇松解翼状胬肉切除联合角膜缘上皮移植的疗效观察
黄悦	天津医科大学眼科医院	国际眼科杂志	纤维蛋白胶在翼状胬肉切除联合自体角膜缘干细胞移植术中的临床效果
黄悦	天津医科大学眼科研究所	国际眼科杂志	表面麻醉下翼状胬肉手术中应用纤维蛋白胶的效果
黄惠萍	甘肃省高台县人民医院眼科	眼外伤职业眼病杂志	头发焗油致过敏性结膜炎120例报告
黄慧玲	广东省汕尾市逸挥基金医院眼科	临床眼科杂志	翼状胬肉角膜表面屈光状态分析
黄振平	南京大学医学院临床学院南京军区南京总医院眼科	中华实验眼科杂志	激光共焦显微镜与组织病理学对翼状胬肉组织中微血管密度研究的比较
黄振平	南京军区南京总医院眼科	中华实验眼科杂志	泡性眼炎的激光扫描共焦显微镜下表现
黄挺	中山大学中山眼科中心	中华眼科杂志	急性结膜炎痊愈后泪膜的变化
黄挺	中山大学中山眼科中心	中华眼科杂志	羊膜移植重建静止期眼结膜表面的远期疗效分析
黄文坚	福建省石狮市医院眼耳鼻喉科	中国眼耳鼻喉科杂志	自体角膜缘上皮结膜组织瓣移植术治疗翼状胬肉60例
黄新民	武警广东边防总队医院眼科医疗中心	中国眼耳鼻喉科杂志	角膜缘干细胞移植治疗翼状胬肉
黄新潮	湖北省中山医院眼科	中华实验眼科杂志	盐酸奥洛他定联合环孢素A治疗特应性角膜结膜炎临床观察
黄旅珍	复旦大学附属眼耳鼻喉科医院眼科	中国眼耳鼻喉科杂志	春季角结膜炎中角膜损害的研究进展
黄智	佛山市第一人民医院眼科	眼科	人羊膜移植治疗翼状胬肉等眼表疾病的临床观察
黄梓材	中国广东汕头市中心医院眼科	国际眼科杂志	羊膜移植联合丝裂霉素术中应用预防翼状胬肉复发的前瞻性研究
黄楚良	湖南省岳阳市三人民医院眼科	中国眼耳鼻喉科杂志	翼状胬肉逆行切除联合自体结膜或角膜缘干细胞移植术的疗效观察
黄欣	复旦大学附属眼耳鼻喉科医院眼科	中华眼底病杂志	经双目间接检眼镜激光光凝治疗严重早产儿视网膜病变
黄正茂	盐田区人民医院眼科	眼外伤职业眼病杂志	初发胬肉与复发胬肉中ⅠL-1α和VEGFR-1的表达相关性研究
黄正茂	深圳市梅沙医院	中国实用眼科杂志	IL-1 α在初发与复发性翼状胬肉中的异常表达
黄毅	中国湖北省襄樊市中心医院眼科	国际眼科杂志	高频电灼浚通术治疗泪道阻塞的疗效观察
黄永洪	广东省新兴县人民医院眼科	临床眼科杂志	翼状胬肉切除联合透明角膜切口白内障超声乳化吸除人工晶状体植入术的临床观察
黄洁成	解放军第五医院眼科	眼外伤职业眼病杂志	贝复舒滴眼液在翼状胬肉术后的应用
黄洁成	中国宁夏回族自治区银川市	国际眼科杂志	绿脓杆菌性角膜溃疡抢救成功1例
黄洁成	解放军第五医院	眼外伤职业眼病杂志	羊膜移植治疗眼表疾病临床观察
黄海涛	永州职业技术学院附属医院眼科	国际眼科杂志	改良式角膜缘干细胞移位术治疗早期翼状胬肉的临床研究
黄涛	武警广东边防总队医院眼科医疗中心	中国眼耳鼻喉科杂志	角膜缘干细胞移植治疗翼状胬肉
黄炳护	广西壮族自治区池河市第五人民医院眼科	临床眼科杂志	角膜缘干细胞移植与人羊膜移植治疗翼状胬肉疗效比较
黄玉庚	浙江省舟山市普陀人民医院眼科	中国中医眼科杂志	翼状胬肉切除术后辅用中药的疗效观察
黄玉敏	中国广东省中山市人民医院眼科	国际眼科杂志	环孢霉素A在防止翼状胬肉复发中的作用
黄玉琴	中国中医科学院江苏分院眼科	国际眼科杂志	Vogt-小柳-原田综合征的临床误诊分析
黄玉萍	固始县人民医院	眼外伤职业眼病杂志	结膜瓣转移联合低浓度丝裂霉素C治疗翼状胬肉
黄玲	核工业四一六医院眼科	国际眼科杂志	翼状胬肉术后90Srβ射线敷贴治疗疗效观察及复发相关因素分析
黄瑞勇	平果县人民医院检验科	眼科	感染性眼病的细菌病原学及药物敏感性分析
黄田河	中国广东省深圳市宝安区石岩人民医院眼科	国际眼科杂志	自体角膜缘干细胞移植术与传统术式治疗翼状胬肉的对比研究
黄祥瑞	中国人民解放军军事医学科学院	中国中医眼科杂志	柳叶液抑制肠病毒70型的体外实验研究
黄筱鸣	浙江省岱山县第一人民医院眼科	眼外伤职业眼病杂志	自体角膜缘干细胞移植治疗翼状胬肉
黄筱鸣	岱山县第一人民医院	眼外伤职业眼病杂志	新鲜人羊膜移植治疗翼状胬肉的临床观察
黄紫清	广西南宁市第一人民医院	眼外伤职业眼病杂志	保存人羊膜在眼表疾病中的应用
黄红	中国新疆维吾尔自治区乌鲁木齐市	国际眼科杂志	春季卡他性结膜炎患者泪液β2微球蛋白的测定及意义
黄红	解放军第546医院五官科	国际眼科杂志	带角膜缘干细胞结膜瓣移植治疗复发性翼状胬肉
黄耀忠	台州市椒江眼科医院	眼外伤职业眼病杂志	翼状胬肉逆向切除联合羊膜移植的临床观察
黄艳明	第三军医大学新桥医院眼科	中国眼耳鼻喉科杂志	翼状胬肉术后巩膜溶解的临床观察
黄艺	喀什农三师医院眼科	眼外伤职业眼病杂志	自体角膜缘干细胞移植治疗翼状胬肉148例
黄芳	温州医学院附属眼视光医院	中华眼视光学与视觉科学杂志	翼状胬肉与角膜散光的观察
黄芳	山东省威海市立医院眼科	中国眼耳鼻喉科杂志	新生儿泪囊炎的按摩治疗法
黄芳	温州医学院附属眼视光医院	中华眼视光学与视觉科学杂志	翼状胬肉逆行切除加羊膜移植的临床疗效
黄菊天	深圳市人民医院暨南大学医学院第二附属医院眼科	眼外伤职业眼病杂志	角膜缘移植联合羊膜移植治疗角膜缘缺陷症
黄菊天	暨南大学医学院附属第二医院	眼外伤职业眼病杂志	羊膜移植结膜囊再造治疗睑球粘连的临床观察
黄菊天	深圳市人民医院暨南大学医学院第二附属医院眼科	中国实用眼科杂志	新鲜羊膜移植治疗翼状胬肉的临床疗效
黄菊天	暨南大学医学院附属二医院眼科	眼外伤职业眼病杂志	羊膜联合自体角膜缘移植治疗复发性翼状胬肉
黄菊天	深圳市人民医院暨南大学医学院二附院	眼科	新鲜羊膜移植治疗眼化学伤和翼状胬肉
黄萍	烟台市牟平区中医院眼科	中国中医眼科杂志	双眼翼状胬肉切除联合角膜缘干细胞移植术的临床应用
黄超英	广西南宁市第一人民医院	眼外伤职业眼病杂志	保存人羊膜在眼表疾病中的应用
黄锦海	温州医学院附属眼视光医院	中国实用眼科杂志	应用活体共焦显微镜观察翼状胬肉组织结构
黄雄	汕头大学医学院第一附属医院皮肤科	眼科	老年人带状疱疹性眼病的特点
黄雄高	海南医学院附属医院	眼外伤职业眼病杂志	两种术式联合丝裂霉素C治疗翼状胬肉
黄静	广州市妇女儿童医疗中心眼科	中国斜视与小儿眼科杂志	104例儿童异常瞬目临床诊疗分析
黄颖妮	中国陕西省西安市第四人民医院眼科	国际眼科杂志	西安周边50岁及以上农村人口眼病调查
黄黎黎	南通市第一人民医院眼科	中华实验眼科杂志	纤维蛋白胶在兔眼翼状胬肉自体结膜瓣转移手术中的应用
黎仕强	中山大学中山眼科中心遗传分子生物学实验室	临床眼科杂志	PCR扩增技术在新生儿结膜炎中的诊断应用
黎小军	兰州大学第一医院眼科	中国中医眼科杂志	自体角膜缘干细胞及羊膜对翼状胬肉TNF-α、IL-6表达的影响
黎明	暨南大学附属深圳市眼科医院	中国实用眼科杂志	新生儿急性细菌性结膜炎10年致病菌变迁
黎明	深圳市眼科医院	中华实验眼科杂志	翼状胬肉组织中环氧化酶-2及p21-ras的表达研究
黎明	中山大学中山眼科中心	中国实用眼科杂志	翼状胬肉切除对泪液功能的影响
黎明	暨南大学附属深圳眼科医院	中国斜视与小儿眼科杂志	新生儿急性细菌性结膜炎病原菌及药物敏感性分析
黎明	深圳暨南大学附属深圳市眼科医院	中国斜视与小儿眼科杂志	新生儿淋菌性结膜炎致病菌10年药物敏感性的变迁
黎明	中山大学中山眼科中心	中国实用眼科杂志	新生儿急性细菌性结膜炎细菌培养结果分析
黎明	中国广东省深圳市眼科医院角膜及眼表疾病科	国际眼科杂志	翼状胬肉术后不同处理方法对创面上皮修复的影响
黎明	暨南大学附属深圳市眼科医院	眼科	特应性角结膜炎治疗前后共焦显微镜检查二例
黎明	暨南大学附属深圳市眼科医院	国际眼科杂志	改良纤维蛋白粘合剂在眼表翼状胬肉手术中的应用
黎春雷	中国广东省茂名市人民医院眼科	国际眼科杂志	带角膜缘干细胞自体结膜瓣移植术治疗翼状胬肉
黎晓新	北京大学人民医院眼科	临床眼科杂志	急性结膜囊肿1例
黎智	湖北省襄阳市中心医院眼科	临床眼科杂志	翼状胬肉切除联合应用丝裂霉素 C 与自体结膜移植治疗翼状胬肉的 Meta 分析
黎犁	湖北省宜昌市夷陵医院眼科	中国眼耳鼻喉科杂志	氟康唑联合聚维酮碘治疗真菌性结膜炎
齐卫	深圳市梅沙医院	中国实用眼科杂志	IL-1 α在初发与复发性翼状胬肉中的异常表达
齐备	上海诺华视康隐形眼镜有限公司	中华眼视光学与视觉科学杂志	巨乳头性结膜炎的免疫学研究
齐虹	北京大学第三医院	眼外伤职业眼病杂志	胚胎角膜干细胞移植治疗翼状胬肉的远期临床观察
龍厚飛	中國江西省吉安市中心人民醫院眼科	国际眼科杂志	人羊膜移植治療翼狀胬肉的臨床分析
龔向明	中國廣州中山醫科大學中山眼科中心	国际眼科杂志	羊膜移植治療翼狀胬肉
龙崇德	中山眼科中心	眼外伤职业眼病杂志	初发胬肉与复发胬肉中ⅠL-1α和VEGFR-1的表达相关性研究
龙心光	广东医学院附属医院眼科	中国中医眼科杂志	高三尖杉酯碱和血栓通对人翼状胬肉成纤维细胞周期性变化的影响
龙波	四川省遂宁市人民医院眼科	临床眼科杂志	结角膜鳞状细胞癌1例
龙波	中国四川省遂宁市中心医院眼科	国际眼科杂志	角膜缘干细胞移植联合贝复舒眼液治疗复发性翼状胬肉的临床观察
龙潭	中国陕西省西安市眼科医院	国际眼科杂志	翼状胬肉切除联合丝裂霉素C术后巩膜溶解的分析
龙登虹	海口，海南省人民医院眼科	中华眼科杂志	海南省两县(市)翼状胬肉患病率的调查
龙虎跃	娄底眼科医院	眼外伤职业眼病杂志	角膜缘干细胞移植治疗翼状胬肉76例疗效观察
龚丽华	上海交通大学附属上海市第六人民医院眼科	中华实验眼科杂志	翼状胬肉切除联合结膜转位及视原植入术治疗翼状胬肉的疗效观察
龚丽华	上海交通大学附属上海市第六人民医院眼科	临床眼科杂志	单纯结膜转位术与联合视原胶原植入术治疗翼状胬肉的疗效观察
龚向明	中山大学中山眼科中心	国际眼科杂志	复发性与原发性翼状胬肉广泛切除联合羊膜移植治疗观察
龚岚	复旦大学附属眼耳鼻喉科医院眼科	中华眼科杂志	加替沙星和左氧氟沙星治疗细菌性结膜炎的疗效对比研究
龚岚	复旦大学附属眼耳鼻喉科医院	中华眼科杂志	眼部自然杀伤-T细胞淋巴瘤致角膜穿孔一例
龚岚	复旦大学附属眼耳鼻喉科医院眼科	中华眼科杂志	异体巩膜移植治疗复发性瘢痕性睑内翻的临床分析
龚岚	复旦大学附属眼耳鼻喉科医院眼科	中国实用眼科杂志	富马酸酮替芬滴眼液治疗季节变应性结膜炎眼痒及结膜充血的疗效观察
龚岚	复旦大学附属眼耳鼻喉科医院眼科	眼科	奥洛他定治疗儿童过敏性结膜炎合并瞬目频繁的疗效观察
龚春英	广州医学院荔湾医院眼科	国际眼科杂志	复发性与原发性翼状胬肉广泛切除联合羊膜移植治疗观察
龚桦	广州医学院荔湾医院眼科	国际眼科杂志	复发性与原发性翼状胬肉广泛切除联合羊膜移植治疗观察
龚永祥	云南省红十字会医院眼科	眼外伤职业眼病杂志	空气中的污染物致翼状胬肉的职业流行病学调查报告
