an yuzhi	China:Capital Med Univ, Beijing Tongren Hosp, Beijing Tongren Eye Ctr, Beijing Inst Ophthalmol, Beijing,Peoples R China. Capital Medical University	GRAEFES ARCHIVE FOR CLINICAL AND EXPERIMENTAL OPHTHALMOLOGY	Epithelial tumors of the lacrimal gland in the Chinese: a clinicopathologic study of 298 patients
bai fang	China:Armed Police Gen Hosp China, Lacrimal Ctr Ophthalmol, Beijing 100039,Peoples R China. 	INTERNATIONAL JOURNAL OF OPHTHALMOLOGY	Diagnosis of lacrimal canalicular diseases using ultrasound biomicroscopy: a preliminary study
bi x	China:Shanghai Jiao Tong Univ, Sch Med, Shanghai Peoples Hosp 9, Dept Ophthalmol, Shanghai 200011,Peoples R China. Shanghai Jiao Tong University	EYE	The use of Medpor coated tear drainage tube in conjunctivodacryocystorhinostomy
bi x	China:Shanghai Jiao Tong Univ, Sch Med, Shanghai Peoples Hosp 9, Dept Ophthalmol, Shanghai 200011,Peoples R China. Shanghai Jiao Tong University	OPHTHALMIC PLASTIC AND RECONSTRUCTIVE SURGERY	Palpebral Lipogranuloma Caused by Transcanalicular Ointment Injection After Laser Canaliculoplasty
bi y	China:Tongji Univ, Dept Ophthalmol, Tongji Hosp, Sch Med, Shanghai 200092,Peoples R China. Tongji University	EYE	Two-step retrograde closed stenting: a novel method for treating canalicular lacerations in Chinese patients
boost maureen	China:Hong Kong Polytech Univ, Dept Hlth Technol & Informat, Kowloon, Hong Kong,Peoples R China. Hong Kong Polytechnic University	CLINICAL AND EXPERIMENTAL OPTOMETRY	Corneal epithelial cell viability of an ex vivo porcine eye model
cai jianqiu	China:Wenzhou Med Coll, Yuying Childrens Hosp, Affiliated Hosp 2, Wenzhou 325000, Zhejiang,Peoples R China. Wenzhou Medical University	CANADIAN JOURNAL OF OPHTHALMOLOGY-JOURNAL CANADIEN D OPHTALMOLOGIE	A meta-analysis of primary dacryocystorhinostomy with and without silicone intubation
chan clementwainang	China:Tung Wah Eastern Hosp, Dept Ophthalmol, Hong Kong, Hong Kong,Peoples R China. 	INTERNATIONAL JOURNAL OF OPHTHALMOLOGY	Clinicopathological survey of 23 patients with lacrimal fossa lesions in Hong Kong
chan edwin	China:Tung Wah Eastern Hosp, Dept Ophthalmol, Hong Kong, Hong Kong,Peoples R China. 	INTERNATIONAL JOURNAL OF OPHTHALMOLOGY	Clinicopathological survey of 23 patients with lacrimal fossa lesions in Hong Kong
chan kayin	China:Hong Kong Polytech Univ, Sch Optometry, Kowloon, Hong Kong,Peoples R China. Hong Kong Polytechnic University	CLINICAL AND EXPERIMENTAL OPTOMETRY	Corneal epithelial cell viability of an ex vivo porcine eye model
chen d	China:Sun Yat Sen Univ, Affiliated Hosp 1, Dept ENT, Guangzhou 510060, Guangdong,Peoples R China. Sun Yat Sen University	BRITISH JOURNAL OF OPHTHALMOLOGY	A simple and evolutional approach proven to recanalise the nasolacrimal duct obstruction
chen d	China:Sun Yat Sen Univ, Affiliated Hosp 1, Dept ENT, Guangzhou 510060, Guangdong,Peoples R China. Sun Yat Sen University	BRITISH JOURNAL OF OPHTHALMOLOGY	A novel procedure for treating canalicular obstruction by re-canaliculisation and bicanalicular intubation
chen ding	China:Wenzhou Med Coll, Sch Ophthalmol & Optometry, Wenzhou 325027, Zhejiang,Peoples R China. Wenzhou Medical University	OPTOMETRY AND VISION SCIENCE	Age-Related Changes in Tear Menisci Imaged by Optical Coherence Tomography
chen jinpeng	China:Wenzhou Med Coll, Sch Ophthalmol & Optometry, Wenzhou 325027, Zhejiang,Peoples R China. Wenzhou Medical University	INVESTIGATIVE OPHTHALMOLOGY & VISUAL SCIENCE	A murine model of dry eye induced by an intelligently controlled environmental system
chen mei	China:Hunan Univ Tradit Chinese Med, Affiliated Hosp 1, Dept Ophthalmol, Changsha 410007, Hunan,Peoples R China. 	INTERNATIONAL JOURNAL OF OPHTHALMOLOGY	Effects of extract of Buddleja officinalis on partial inflammation of lacrimal gland in castrated rabbits with dry eye
chen wei	China:Wenzhou Med Coll, Sch Ophthalmol & Optometry, Wenzhou 325027, Zhejiang,Peoples R China. Wenzhou Medical University	INVESTIGATIVE OPHTHALMOLOGY & VISUAL SCIENCE	A murine model of dry eye induced by an intelligently controlled environmental system
chen xp	China:Sun Yat Sen Univ, Ocular Surface Ctr, Zhongshan Ophthalm Ctr, State Key Lab Ophthalmol, Guangzhou,Peoples R China. Sun Yat Sen University	EXPERIMENTAL EYE RESEARCH	MUC19 expression in human ocular surface and lacrimal gland and its alteration in Sjogren syndrome patients
chen zhao	China:Wenzhou Med Coll, Sch Ophthalmol & Optometry, Wenzhou 325027, Zhejiang,Peoples R China. Wenzhou Medical University	OPTOMETRY AND VISION SCIENCE	Age-Related Changes in Tear Menisci Imaged by Optical Coherence Tomography
chen zhiyuan	China:Peking Univ, Hosp Stomatol, Dept Oral & Maxillofacial Surg, Beijing 100081,Peoples R China. Peking University	CORNEA	Establishment of a Rabbit Model for Keratoconjunctivitis Sicca
chen zhiyuan	China:Peking Univ, Hosp Stomatol, Dept Oral & Maxillofacial Surg, Beijing 100081,Peoples R China. Peking University	INVESTIGATIVE OPHTHALMOLOGY & VISUAL SCIENCE	Treatment of Severe Keratoconjunctivitis Sicca by Parotid Duct Transposition after Tympanic Neurectomy in Rabbits
chen zhuo	China:Baylor Coll Med, Cullen Eye Inst, Dept Ophthalmol, Ocular Surface Ctr, Houston, TX 77030 USA. Baylor College of Medicine	INVESTIGATIVE OPHTHALMOLOGY & VISUAL SCIENCE	Altered Morphology and Function of the Lacrimal Functional Unit in Protein Kinase C alpha Knockout Mice
cheng cheng	China:Hosp Author Ophthalm Serv, Hong Kong Eye Hosp, Hong Kong, Hong Kong,Peoples R China. 	OPHTHALMIC PLASTIC AND RECONSTRUCTIVE SURGERY	Limited Nasal Septoplasty by Ophthalmologists During Endonasal Dacryocystorhinostomy: Is It Safe?
cheng shiming	China:Hubei Univ Med, Taihe Hosp, Dept Ophthalmol, Shijiazhuang, Hubei,Peoples R China. 	PLOS ONE	Efficacy of Mitomycin C in Endoscopic Dacryocystorhinostomy: A Systematic Review and Meta-Analysis
chi chi	China:Chinese Univ Hong Kong, Dept Ophthalmol & Visual Sci, Hong Kong, Hong Kong,Peoples R China. Chinese University of Hong Kong	CORNEA	Pediatric Ocular Surface Infections: A 5-year Review of Demographics, Clinical Features, Risk Factors, Microbiological Results, and Treatment
cho pauline	China:Hong Kong Polytech Univ, Sch Optometry, Kowloon, Hong Kong,Peoples R China. Hong Kong Polytechnic University	CLINICAL AND EXPERIMENTAL OPTOMETRY	Corneal epithelial cell viability of an ex vivo porcine eye model
chong chong	China:Prince Wales Hosp, Dept Ophthalmol & Visual Sci, Hong Kong, Hong Kong,Peoples R China. Chinese University of Hong KongPrince of Wales Hospital	OPHTHALMOLOGY	Randomized Trial on Silicone Intubation in Endoscopic Mechanical Dacryocystorhinostomy (SEND) for Primary Nasolacrimal Duct Obstruction
chu chingyan	China:Chinese Univ Hong Kong, Prince Wales Hosp, Dept Obstet & Gynaecol, Shatin, Hong Kong,Peoples R China. Chinese University of Hong KongPrince of Wales Hospital	ARCHIVES OF OPHTHALMOLOGY	Association of Hemopexin in Tear Film and Conjunctival Macrophages With Vernal Keratoconjunctivitis
cui lele	China:Wenzhou Med Coll, Sch Ophthalmol & Optometry, Wenzhou 325027, Zhejiang,Peoples R China. Wenzhou Medical University	OPTOMETRY AND VISION SCIENCE	Age-Related Changes in Tear Menisci Imaged by Optical Coherence Tomography
deng xinguo	China:Sun Yat Sen Univ, Zhongshan Ophthalm Ctr, State Key Lab Ophthalmol, Guangzhou 510060, Guangdong,Peoples R China. Sun Yat Sen University	BMC OPHTHALMOLOGY	Establishment of the mild, moderate and severe dry eye models using three methods in rabbits
dong nuo	China:Xiamen Univ, Affiliated Xiamen Eye Ctr, Xiamen, Fujian,Peoples R China. Xiamen University	PLOS ONE	Air Exposure Induced Characteristics of Dry Eye in Conjunctival Tissue Culture
dong wenjia	China:Nanchang Univ, Dept Ophthalmol, Affiliated Hosp 1, Nanchang 330006, Jiangxi,Peoples R China. Nanchang University	INTERNATIONAL JOURNAL OF OPHTHALMOLOGY	Aerocyst urethral catheter insertion compared to expansion sponges application in external dacryocystorhinostomy
fan x	China:Shanghai Jiao Tong Univ, Sch Med, Shanghai Peoples Hosp 9, Dept Ophthalmol, Shanghai 200011,Peoples R China. Shanghai Jiao Tong University	EYE	The use of Medpor coated tear drainage tube in conjunctivodacryocystorhinostomy
fan x	China:Shanghai Jiao Tong Univ, Sch Med, Shanghai Peoples Hosp 9, Dept Ophthalmol, Shanghai 200011,Peoples R China. Shanghai Jiao Tong University	OPHTHALMIC PLASTIC AND RECONSTRUCTIVE SURGERY	Palpebral Lipogranuloma Caused by Transcanalicular Ointment Injection After Laser Canaliculoplasty
fan x	China:Shanghai Jiao Tong Univ, Sch Med, Shanghai Peoples Hosp 9, Dept Ophthalmol, Shanghai 200011,Peoples R China. Shanghai Jiao Tong University	JOURNAL OF OCULAR PHARMACOLOGY AND THERAPEUTICS	Clinical Outcomes of Dacryocystorhinostomy With or Without Intraoperative Use of Mitomycin C: A Systematic Review and Meta-Analysis
feng yifan	China:Fudan Univ, Dept Ophthalmol, Zhongshan Hosp, Shanghai 200433,Peoples R China. Fudan University	PLOS ONE	Efficacy of Mitomycin C in Endoscopic Dacryocystorhinostomy: A Systematic Review and Meta-Analysis
feng yifan	China:Wenzhou Med Coll, Affiliated Eye Hosp, Sch Ophthalmol & Optometry, Wenzhou 325027, Zhejiang,Peoples R China. Wenzhou Medical University	OPHTHALMIC EPIDEMIOLOGY	A Meta-analysis of Primary External Dacryocystorhinostomy With and Without Mitomycin C
feng yifan	China:Wenzhou Med Coll, Affiliated Eye Hosp, Sch Ophthalmol & Optometry, Wenzhou 325027, Zhejiang,Peoples R China. Wenzhou Medical University	CANADIAN JOURNAL OF OPHTHALMOLOGY-JOURNAL CANADIEN D OPHTALMOLOGIE	A meta-analysis of primary dacryocystorhinostomy with and without silicone intubation
fu y	China:Shanghai Jiao Tong Univ, Sch Med, Shanghai Peoples Hosp 9, Dept Ophthalmol, Shanghai 200011,Peoples R China. Shanghai Jiao Tong University	EYE	The use of Medpor coated tear drainage tube in conjunctivodacryocystorhinostomy
gao fei	China:Capital Med Univ, Beijing Tongren Hosp, Beijing Tongren Eye Ctr, Beijing Inst Ophthalmol, Beijing,Peoples R China. Capital Medical University	GRAEFES ARCHIVE FOR CLINICAL AND EXPERIMENTAL OPHTHALMOLOGY	Epithelial tumors of the lacrimal gland in the Chinese: a clinicopathologic study of 298 patients
gao guiping	China:Nanchang Univ, Dept Ophthalmol, Affiliated Hosp 1, Nanchang 330006, Jiangxi,Peoples R China. Nanchang University	INTERNATIONAL JOURNAL OF OPHTHALMOLOGY	Aerocyst urethral catheter insertion compared to expansion sponges application in external dacryocystorhinostomy
gao q	China:Sun Yat Sen Univ, Zhongshan Ophthalm Ctr, State Key Lab Ophthalmol, Guangzhou 510060, Guangdong,Peoples R China. Sun Yat Sen University	BRITISH JOURNAL OF OPHTHALMOLOGY	A simple and evolutional approach proven to recanalise the nasolacrimal duct obstruction
gao shaohui	China:Sun Yat Sen Univ, Zhongshan Ophthalm Ctr, State Key Lab Ophthalmol, Guangzhou 510060, Guangdong,Peoples R China. Sun Yat Sen University	GRAEFES ARCHIVE FOR CLINICAL AND EXPERIMENTAL OPHTHALMOLOGY	Metastatic orbital tumors in southern China during an 18-year period
gao yang	China:Sun Yat Sen Univ, Zhongshan Ophthalm Ctr, State Key Lab Ophthalmol, Guangzhou 510060, Guangdong,Peoples R China. Sun Yat Sen University	BMC OPHTHALMOLOGY	Establishment of the mild, moderate and severe dry eye models using three methods in rabbits
ge j	China:Sun Yat Sen Univ, Zhongshan Ophthalm Ctr, State Key Lab Ophthalmol, Guangzhou 510060, Guangdong,Peoples R China. Sun Yat Sen University	BRITISH JOURNAL OF OPHTHALMOLOGY	A simple and evolutional approach proven to recanalise the nasolacrimal duct obstruction
ge j	China:Sun Yat Sen Univ, Zhongshan Ophthalm Ctr, State Key Lab Ophthalmol, Guangzhou 510060, Guangdong,Peoples R China. Sun Yat Sen University	BRITISH JOURNAL OF OPHTHALMOLOGY	Novel air-injection technique to locate the medial cut end of lacerated canaliculus
ge shengfang	China:Shanghai Jiao Tong Univ, Dept Ophthalmol, Shanghai Peoples Hosp 9, Sch Med, Shanghai 200011,Peoples R China. Shanghai Jiao Tong University	OPHTHALMIC PLASTIC AND RECONSTRUCTIVE SURGERY	Palpebral Lipogranuloma Caused by Transcanalicular Ointment Injection After Laser Canaliculoplasty
ge xin	China:Capital Med Univ, Beijing Tongren Hosp, Beijing Tongren Eye Ctr, Beijing Ophthalmol & Visual Sci Key Lab, Beijing 100730,Peoples R China. Capital Medical University	INTERNATIONAL JOURNAL OF OPHTHALMOLOGY	Rosai -Dorfman disease of unilateral lacrimal gland in an elderly Chinese male
geng zhixin	China:Xiamen Univ, Affiliated Xiamen Eye Ctr, Xiamen, Fujian,Peoples R China. Xiamen University	PLOS ONE	Air Exposure Induced Characteristics of Dry Eye in Conjunctival Tissue Culture
gong lan	China:Fudan Univ, Eye Ear Nose & Throat Hosp, Dept Ophthalmol, Shanghai 200031,Peoples R China. Fudan University	CURRENT EYE RESEARCH	Efficacy of Acupuncture and Identification of Tear Protein Expression Changes Using iTRAQ Quantitative Proteomics in Rabbits
guo jie	China:Fudan Univ, Dept Ophthalmol, Eye & ENT Hosp, Shanghai 200433,Peoples R China. Fudan University	CURRENT EYE RESEARCH	Histopathology and Immunohistochemical Profile in Idiopathic Dacryoadenitis
guo jie	China:Fudan Univ, Dept Ophthalmol, Eye & ENT Hosp, Shanghai 200433,Peoples R China. Fudan University	CURRENT EYE RESEARCH	Expression of Interleukin-17 in Autoimmune Dacryoadenitis in MRL/lpr Mice
guo jingchun	China:Fudan Univ, Shanghai Med Coll, State Key Lab Med Neurobiol, Shanghai 200031,Peoples R China. Fudan University	CURRENT EYE RESEARCH	Efficacy of Acupuncture and Identification of Tear Protein Expression Changes Using iTRAQ Quantitative Proteomics in Rabbits
han cai	China:Armed Police Gen Hosp China, Lacrimal Ctr Ophthalmol, Beijing 100039,Peoples R China. 	INTERNATIONAL JOURNAL OF OPHTHALMOLOGY	Diagnosis of lacrimal canalicular diseases using ultrasound biomicroscopy: a preliminary study
han jm	China:Sun Yat Sen Univ, Ctr Canc, State Key Lab Oncol, Guangzhou,Peoples R China. Sun Yat Sen University	EXPERIMENTAL EYE RESEARCH	MUC19 expression in human ocular surface and lacrimal gland and its alteration in Sjogren syndrome patients
han xiaohui	China:Wenzhou Med Coll, Yuying Childrens Hosp, Affiliated Hosp 2, Wenzhou 325000, Zhejiang,Peoples R China. Wenzhou Medical University	CANADIAN JOURNAL OF OPHTHALMOLOGY-JOURNAL CANADIEN D OPHTALMOLOGIE	A meta-analysis of primary dacryocystorhinostomy with and without silicone intubation
he meifeng	China:Sun Yat Sen Univ, Zhongshan Ophthalm Ctr, State Key Lab Ophthalmol, Guangzhou 510060, Guangdong,Peoples R China. Sun Yat Sen University	BMC OPHTHALMOLOGY	Establishment of the mild, moderate and severe dry eye models using three methods in rabbits
ho mary	China:Prince Wales Hosp, Dept Ophthalmol & Visual Sci, Hong Kong, Hong Kong,Peoples R China. Chinese University of Hong KongPrince of Wales Hospital	OPHTHALMOLOGY	Randomized Trial on Silicone Intubation in Endoscopic Mechanical Dacryocystorhinostomy (SEND) for Primary Nasolacrimal Duct Obstruction
huang jinhai	China:Wenzhou Med Coll, Affiliated Eye Hosp, Sch Ophthalmol & Optometry, Wenzhou 325027, Zhejiang,Peoples R China. Wenzhou Medical University	OPHTHALMIC EPIDEMIOLOGY	A Meta-analysis of Primary External Dacryocystorhinostomy With and Without Mitomycin C
huang jinhai	China:Wenzhou Med Coll, Affiliated Eye Hosp, Sch Ophthalmol & Optometry, Wenzhou 325027, Zhejiang,Peoples R China. Wenzhou Medical University	PLOS ONE	Efficacy of Mitomycin C in Endoscopic Dacryocystorhinostomy: A Systematic Review and Meta-Analysis
huang xuequan	China:Third Mil Med Univ, Southwest Hosp, Dept Radiol, Chongqing 400038,Peoples R China. Third Military Medical University	EUROPEAN JOURNAL OF OPHTHALMOLOGY	Adenoid cystic carcinoma of the lacrimal gland: CT and MRI findings
io idayufong	China:Caritas Med Ctr, Dept Ophthalmol, Kowloon, Hong Kong,Peoples R China. 	GRAEFES ARCHIVE FOR CLINICAL AND EXPERIMENTAL OPHTHALMOLOGY	Prognostic factors for outcome of endoscopic dacryocystorhinostomy in patients with primary acquired nasolacrimal duct obstruction
ji qingshan	China:Jinan Univ, Affiliated Hosp 1, Dept Ophthalmol, Guangzhou 510632, Guangdong,Peoples R China. Jinan University	INTERNATIONAL JOURNAL OF OPHTHALMOLOGY	New mucosal flap modification for endonasal endoscopic dacryocystorhinostomy in Asians
jiang bing	China:Cent S Univ, Xiangya Hosp 2, Dept Ophthalmol, Changsha 410083, Hunan,Peoples R China. Central South University	OCULAR IMMUNOLOGY AND INFLAMMATION	Granulomatosis with Polyangiitis: The Relationship Between Ocular and Nasal Disease
jiang jun	China:Wenzhou Med Coll, Sch Ophthalmol & Optometry, Wenzhou 325027, Zhejiang,Peoples R China. Wenzhou Medical University	OPTOMETRY AND VISION SCIENCE	Age-Related Changes in Tear Menisci Imaged by Optical Coherence Tomography
jiao yonghong	China:Beijing Tongren Hosp, Beijing Tongren Eye Ctr, Beijing 300070,Peoples R China. Capital Medical University	JOURNAL OF AAPOS	Surgical management of large-angle incomitant strabismus in patients with oculomotor nerve palsy
jie ying	China:Capital Med Univ, Beijing Ophthalmol & Visual Sci Key Lab, Beijing Tongren Eye Ctr, Beijing Tongren Hosp, Beijing,Peoples R China. Capital Medical University	CORNEA	A New Nonhuman Primate Model of Severe Dry Eye
jie ying	China:Capital Med Univ, Beijing Ophthalmol & Visual Sci Key Lab, Beijing Tongren Eye Ctr, Beijing Tongren Hosp, Beijing,Peoples R China. Capital Medical University	INVESTIGATIVE OPHTHALMOLOGY & VISUAL SCIENCE	Treatment of Severe Keratoconjunctivitis Sicca by Parotid Duct Transposition after Tympanic Neurectomy in Rabbits
jin xiuming	China:Zhejiang Univ, Sch Med, Affiliated Hosp 2, Ctr Eye, Hangzhou 310009, Zhejiang,Peoples R China. Zhejiang University	OPHTHALMIC PLASTIC AND RECONSTRUCTIVE SURGERY	Use of Crawford Tube for Chronic Suppurative Lacrimal Canaliculitis
jonas jostb	China:Capital Med Univ, Beijing Tongren Hosp, Beijing Tongren Eye Ctr, Beijing Inst Ophthalmol, Beijing,Peoples R China. Capital Medical University	GRAEFES ARCHIVE FOR CLINICAL AND EXPERIMENTAL OPHTHALMOLOGY	Epithelial tumors of the lacrimal gland in the Chinese: a clinicopathologic study of 298 patients
kuk kuk	China:Univ Hong Kong, Dept Ophthalmol, Hong Kong, Hong Kong,Peoples R China. University of Hong Kong	CURRENT OPINION IN OPHTHALMOLOGY	Evidence-based review of surgical practices in endoscopic endonasal dacryocystorhinostomy for primary acquired nasolacrimal duct obstruction and other new indications
labbe antoine	China:Univ Paris 06, INSERM, CNRS, Inst Vis,UMR S 968,UMR 7210,U968, Paris, France. Centre National de la Recherche Scientifique (CNRS)Pierre & Marie Curie University - Paris 6Institut National de la Sante et de la Recherche Medicale (Inserm)	CORNEA	A New Nonhuman Primate Model of Severe Dry Eye
lai lai	China:Prince Wales Hosp, Dept Ophthalmol & Visual Sci, Hong Kong, Hong Kong,Peoples R China. Chinese University of Hong KongPrince of Wales Hospital	OPHTHALMOLOGY	Randomized Trial on Silicone Intubation in Endoscopic Mechanical Dacryocystorhinostomy (SEND) for Primary Nasolacrimal Duct Obstruction
lai lai	China:Prince Wales Hosp, Dept Ophthalmol & Visual Sci, Hong Kong, Hong Kong,Peoples R China. Chinese University of Hong KongPrince of Wales Hospital	CORNEA	Pediatric Ocular Surface Infections: A 5-year Review of Demographics, Clinical Features, Risk Factors, Microbiological Results, and Treatment
lam lam	China:Chinese Univ Hong Kong, Dept Ophthalmol & Visual Sci, Hong Kong, Hong Kong,Peoples R China. Chinese University of Hong Kong	CORNEA	Pediatric Ocular Surface Infections: A 5-year Review of Demographics, Clinical Features, Risk Factors, Microbiological Results, and Treatment
lam lam	China:Chinese Univ Hong Kong, Dept Ophthalmol & Visual Sci, Hong Kong, Hong Kong,Peoples R China. Chinese University of Hong Kong	ARCHIVES OF OPHTHALMOLOGY	Association of Hemopexin in Tear Film and Conjunctival Macrophages With Vernal Keratoconjunctivitis
lee allie	China:Chinese Univ Hong Kong, Dept Ophthalmol & Visual Sci, Hong Kong, Hong Kong,Peoples R China. Chinese University of Hong Kong	OPHTHALMIC PLASTIC AND RECONSTRUCTIVE SURGERY	Balloon Dacryoplasty in Internal Ostium Stenosis After Endoscopic Dacryocystorhinostomy
li bin	China:Capital Med Univ, Beijing Tongren Hosp, Beijing Tongren Eye Ctr, Beijing Inst Ophthalmol, Beijing,Peoples R China. Capital Medical University	GRAEFES ARCHIVE FOR CLINICAL AND EXPERIMENTAL OPHTHALMOLOGY	Epithelial tumors of the lacrimal gland in the Chinese: a clinicopathologic study of 298 patients
li cheng	China:Fujian Prov Key Lab Ophthalmol & Visual Sci, Xiamen, Fujian,Peoples R China. 	PLOS ONE	Air Exposure Induced Characteristics of Dry Eye in Conjunctival Tissue Culture
li chuanke	China:Hunan Univ Tradit Chinese Med, Affiliated Hosp 1, Dept Ophthalmol, Changsha 410007, Hunan,Peoples R China. 	INTERNATIONAL JOURNAL OF OPHTHALMOLOGY	Effects of extract of Buddleja officinalis on partial inflammation of lacrimal gland in castrated rabbits with dry eye
li dian	China:Hunan Univ Tradit Chinese Med, Affiliated Hosp 1, Dept Ophthalmol, Changsha 410007, Hunan,Peoples R China. 	INTERNATIONAL JOURNAL OF OPHTHALMOLOGY	Effects of extract of Buddleja officinalis on partial inflammation of lacrimal gland in castrated rabbits with dry eye
li dian	China:Hunan Univ Tradit Chinese Med, Affiliated Hosp 1, Dept Ophthalmol, Changsha 410007, Hunan,Peoples R China. 	INTERNATIONAL JOURNAL OF OPHTHALMOLOGY	Effect of Buddleia flavonoids drug -containing plasma on the expression of STAT1 phosphoprotein in lacrimal gland epithelial cells in vitro
li li	China:Chinese Univ Hong Kong, Dept Ophthalmol & Visual Sci, Hong Kong, Hong Kong,Peoples R China. Chinese University of Hong Kong	OPHTHALMIC PLASTIC AND RECONSTRUCTIVE SURGERY	Balloon Dacryoplasty in Internal Ostium Stenosis After Endoscopic Dacryocystorhinostomy
li hl	China:Cent S Univ, Xiangya Hosp 2, Dept Ophthalmol, Changsha 410011,Peoples R China. Central South University	OPHTHALMOLOGICA	Adult nasolacrimal sac mucocele
li jin	China:Hosp Eye, Wenzhou Med Coll, Wenzhou City 325027,Peoples R China. Wenzhou Medical University	OPHTHALMOLOGY	Primary Treatment of Acute Dacryocystitis by Endoscopic Dacryocystorhinostomy with Silicone Intubation Guided by a Soft Probe
li jing	China:Capital Med Univ, Beijing Tongren Hosp, Beijing Tongren Eye Ctr, Beijing Ophthalmol & Visual Sci Key Lab, Beijing 100730,Peoples R China. Capital Medical University	INTERNATIONAL JOURNAL OF OPHTHALMOLOGY	Rosai -Dorfman disease of unilateral lacrimal gland in an elderly Chinese male
li liaoqing	China:Capital Med Univ, Beijing Tongren Hosp, Beijing Tongren Eye Ctr, Beijing Inst Ophthalmol, Beijing,Peoples R China. Capital Medical University	GRAEFES ARCHIVE FOR CLINICAL AND EXPERIMENTAL OPHTHALMOLOGY	Epithelial tumors of the lacrimal gland in the Chinese: a clinicopathologic study of 298 patients
li lu	China:Chinese Univ Hong Kong, Prince Wales Hosp, Dept Obstet & Gynaecol, Shatin, Hong Kong,Peoples R China. Chinese University of Hong KongPrince of Wales Hospital	ARCHIVES OF OPHTHALMOLOGY	Association of Hemopexin in Tear Film and Conjunctival Macrophages With Vernal Keratoconjunctivitis
li ming	China:Capital Med Univ, Beijing Tongren Hosp, Dept Pathol, Beijing 100730,Peoples R China. Capital Medical University	INTERNATIONAL JOURNAL OF OPHTHALMOLOGY	Rosai -Dorfman disease of unilateral lacrimal gland in an elderly Chinese male
li ming	China:Wenzhou Med Coll, Sch Ophthalmol & Optometry, Wenzhou 325027, Zhejiang,Peoples R China. Wenzhou Medical University	OPTOMETRY AND VISION SCIENCE	Age-Related Changes in Tear Menisci Imaged by Optical Coherence Tomography
li n	China:Sun Yat Sen Univ, State Key Lab Ophthalmol, Zhongshan Ophthalm Ctr, Guangzhou 510060, Guangdong,Peoples R China. Sun Yat Sen University	EYE	A modified bicanalicular intubation procedure to repair canalicular lacerations using silicone tubes
li n	China:Sun Yat Sen Univ, State Key Lab Ophthalmol, Zhongshan Ophthalm Ctr, Guangzhou 510060, Guangdong,Peoples R China. Sun Yat Sen University	BRITISH JOURNAL OF OPHTHALMOLOGY	A simple and evolutional approach proven to recanalise the nasolacrimal duct obstruction
li n	China:Sun Yat Sen Univ, State Key Lab Ophthalmol, Zhongshan Ophthalm Ctr, Guangzhou 510060, Guangdong,Peoples R China. Sun Yat Sen University	BMC OPHTHALMOLOGY	Establishment of the mild, moderate and severe dry eye models using three methods in rabbits
li n	China:Sun Yat Sen Univ, State Key Lab Ophthalmol, Zhongshan Ophthalm Ctr, Guangzhou 510060, Guangdong,Peoples R China. Sun Yat Sen University	BRITISH JOURNAL OF OPHTHALMOLOGY	A novel procedure for treating canalicular obstruction by re-canaliculisation and bicanalicular intubation
li waiying	China:Chinese Univ Hong Kong, Dept Ophthalmol & Visual Sci, Hong Kong Eye Hosp, Kowloon, Hong Kong,Peoples R China. Chinese University of Hong Kong	ARCHIVES OF OPHTHALMOLOGY	Association of Hemopexin in Tear Film and Conjunctival Macrophages With Vernal Keratoconjunctivitis
li wei	China:Xiamen Univ, Affiliated Xiamen Eye Ctr, Xiamen, Fujian,Peoples R China. Xiamen University	PLOS ONE	Air Exposure Induced Characteristics of Dry Eye in Conjunctival Tissue Culture
li yj	China:Cent S Univ, Xiangya Hosp 2, Dept Radiol, Changsha 410011,Peoples R China. Central South University	OPHTHALMOLOGICA	Adult nasolacrimal sac mucocele
li yan	China:Hubei Univ Med, Dongfeng Hosp, Dept Ophthalmol, Shijiazhuang, Hubei,Peoples R China. 	PLOS ONE	Efficacy of Mitomycin C in Endoscopic Dacryocystorhinostomy: A Systematic Review and Meta-Analysis
li yonghao	China:Sun Yat Sen Univ, Zhongshan Ophthalm Ctr, State Key Lab Ophthalmol, Guangzhou 510060, Guangdong,Peoples R China. Sun Yat Sen University	BRITISH JOURNAL OF OPHTHALMOLOGY	Novel air-injection technique to locate the medial cut end of lacerated canaliculus
li zhijie	China:Jinan Univ, Key Lab Regenerat Med, Guangzhou, Guangdong,Peoples R China. Jinan University	INVESTIGATIVE OPHTHALMOLOGY & VISUAL SCIENCE	Altered Morphology and Function of the Lacrimal Functional Unit in Protein Kinase C alpha Knockout Mice
liang ly	China:Sun Yat Sen Univ, Ocular Surface Ctr, Zhongshan Ophthalm Ctr, State Key Lab Ophthalmol, Guangzhou,Peoples R China. Sun Yat Sen University	EXPERIMENTAL EYE RESEARCH	MUC19 expression in human ocular surface and lacrimal gland and its alteration in Sjogren syndrome patients
liang qingfeng	China:Capital Univ Med Sci, Beijing Tongren Hosp, Inst Ophthalmol, Beijing,Peoples R China. Capital Medical University	CORNEA	Establishment of a Rabbit Model for Keratoconjunctivitis Sicca
liang x	China:Sun Yat Sen Univ, State Key Lab Ophthalmol, Zhongshan Ophthalm Ctr, Guangzhou 510060, Guangdong,Peoples R China. Sun Yat Sen University	EYE	A modified bicanalicular intubation procedure to repair canalicular lacerations using silicone tubes
liang x	China:Sun Yat Sen Univ, State Key Lab Ophthalmol, Zhongshan Ophthalm Ctr, Guangzhou 510060, Guangdong,Peoples R China. Sun Yat Sen University	BRITISH JOURNAL OF OPHTHALMOLOGY	Novel air-injection technique to locate the medial cut end of lacerated canaliculus
lin ding	China:Aier Eye Hosp Changsha, Changsha 410015, Hunan,Peoples R China. 	JAPANESE JOURNAL OF OPHTHALMOLOGY	Necessity of Smad4 for the normal development of the mouse lacrimal gland
lin hui	China:Fujian Prov Key Lab Ophthalmol & Visual Sci, Xiamen, Fujian,Peoples R China. 	PLOS ONE	Air Exposure Induced Characteristics of Dry Eye in Conjunctival Tissue Culture
lin l	China:Sun Yat Sen Univ, State Key Lab Ophthalmol, Zhongshan Ophthalm Ctr, Guangzhou 510060, Guangdong,Peoples R China. Sun Yat Sen University	EYE	A modified bicanalicular intubation procedure to repair canalicular lacerations using silicone tubes
lin y	China:Sun Yat Sen Univ, State Key Lab Ophthalmol, Zhongshan Ophthalm Ctr, Guangzhou 510060, Guangdong,Peoples R China. Sun Yat Sen University	EYE	A modified bicanalicular intubation procedure to repair canalicular lacerations using silicone tubes
liu bingqian	China:Sun Yat Sen Univ, Zhongshan Ophthalm Ctr, State Key Lab Ophthalmol, Guangzhou 510060, Guangdong,Peoples R China. Sun Yat Sen University	BRITISH JOURNAL OF OPHTHALMOLOGY	Novel air-injection technique to locate the medial cut end of lacerated canaliculus
liu mingming	China:Third Mil Med Univ, SW Eye Hosp, Southwest Hosp, Chongqing 400038,Peoples R China. Third Military Medical University	EUROPEAN JOURNAL OF OPHTHALMOLOGY	Adenoid cystic carcinoma of the lacrimal gland: CT and MRI findings
liu y	China:Sun Yat Sen Univ, State Key Lab Ophthalmol, Zhongshan Ophthalm Ctr, Guangzhou 510060, Guangdong,Peoples R China. Sun Yat Sen University	EYE	A modified bicanalicular intubation procedure to repair canalicular lacerations using silicone tubes
liu y	China:Sun Yat Sen Univ, State Key Lab Ophthalmol, Zhongshan Ophthalm Ctr, Guangzhou 510060, Guangdong,Peoples R China. Sun Yat Sen University	CORNEA	Changes of Chloride Channels in the Lacrimal Glands of a Rabbit Model of Sjogren Syndrome
liu y	China:Sun Yat Sen Univ, State Key Lab Ophthalmol, Zhongshan Ophthalm Ctr, Guangzhou 510060, Guangdong,Peoples R China. Sun Yat Sen University	BRITISH JOURNAL OF OPHTHALMOLOGY	A novel procedure for treating canalicular obstruction by re-canaliculisation and bicanalicular intubation
liu ying	China:Aier Eye Hosp Changsha, Changsha 410015, Hunan,Peoples R China. 	JAPANESE JOURNAL OF OPHTHALMOLOGY	Necessity of Smad4 for the normal development of the mouse lacrimal gland
liu z	China:Sun Yat Sen Univ, State Key Lab Ophthalmol, Zhongshan Ophthalm Ctr, Guangzhou 510060, Guangdong,Peoples R China. Sun Yat Sen University	EYE	A modified bicanalicular intubation procedure to repair canalicular lacerations using silicone tubes
liu z	China:Sun Yat Sen Univ, State Key Lab Ophthalmol, Zhongshan Ophthalm Ctr, Guangzhou 510060, Guangdong,Peoples R China. Sun Yat Sen University	EXPERIMENTAL EYE RESEARCH	MUC19 expression in human ocular surface and lacrimal gland and its alteration in Sjogren syndrome patients
liu zuguo	China:Xiamen Univ, Affiliated Xiamen Eye Ctr, Xiamen, Fujian,Peoples R China. Xiamen University	PLOS ONE	Air Exposure Induced Characteristics of Dry Eye in Conjunctival Tissue Culture
long chongde	China:Sun Yat Sen Univ, Zhongshan Ophthalm Ctr, State Key Lab Ophthalmol, Guangzhou 510060, Guangdong,Peoples R China. Sun Yat Sen University	BRITISH JOURNAL OF OPHTHALMOLOGY	Novel air-injection technique to locate the medial cut end of lacerated canaliculus
lu fan	China:Wenzhou Med Coll, Sch Ophthalmol & Optometry, Wenzhou 325027, Zhejiang,Peoples R China. Wenzhou Medical University	OPTOMETRY AND VISION SCIENCE	Age-Related Changes in Tear Menisci Imaged by Optical Coherence Tomography
lu wei	China:Beijing Tongren Hosp, Beijing Tongren Eye Ctr, Beijing 300070,Peoples R China. Capital Medical University	JOURNAL OF AAPOS	Surgical management of large-angle incomitant strabismus in patients with oculomotor nerve palsy
lui waiting	China:Chinese Univ Hong Kong, Prince Wales Hosp, Dept Obstet & Gynaecol, Shatin, Hong Kong,Peoples R China. Chinese University of Hong KongPrince of Wales Hospital	ARCHIVES OF OPHTHALMOLOGY	Association of Hemopexin in Tear Film and Conjunctival Macrophages With Vernal Keratoconjunctivitis
luk abbie	China:Prince Wales Hosp, Dept Ophthalmol & Visual Sci, Hong Kong, Hong Kong,Peoples R China. Chinese University of Hong KongPrince of Wales Hospital	OPHTHALMOLOGY	Randomized Trial on Silicone Intubation in Endoscopic Mechanical Dacryocystorhinostomy (SEND) for Primary Nasolacrimal Duct Obstruction
ma jianmin	China:Capital Med Univ, Beijing Tongren Hosp, Beijing Tongren Eye Ctr, Beijing Ophthalmol & Visual Sci Key Lab, Beijing 100730,Peoples R China. Capital Medical University	INTERNATIONAL JOURNAL OF OPHTHALMOLOGY	Rosai -Dorfman disease of unilateral lacrimal gland in an elderly Chinese male
ma p	China:Sun Yat Sen Univ, Zhongshan Ophthalm Ctr, State Key Lab Ophthalmol, Guangzhou 510060, Guangdong,Peoples R China. Sun Yat Sen University	BRITISH JOURNAL OF OPHTHALMOLOGY	A simple and evolutional approach proven to recanalise the nasolacrimal duct obstruction
mak st	China:Caritas Med Ctr, Dept Ophthalmol, Hong Kong, Hong Kong,Peoples R China. 	EYE	Comment on 'Effects of Merogel coverage on wound healing and ostial patency in endonasal endoscopic dacryocytorhinostomy for primary chronic dacryocystitis'
mak shiuting	China:United Christian Hosp, Dept Ophthalmol, Kowloon, Hong Kong,Peoples R China. 	GRAEFES ARCHIVE FOR CLINICAL AND EXPERIMENTAL OPHTHALMOLOGY	Prognostic factors for outcome of endoscopic dacryocystorhinostomy in patients with primary acquired nasolacrimal duct obstruction
marcet marcusm	China:Univ Hong Kong, Dept Ophthalmol, Hong Kong, Hong Kong,Peoples R China. University of Hong Kong	CURRENT OPINION IN OPHTHALMOLOGY	Evidence-based review of surgical practices in endoscopic endonasal dacryocystorhinostomy for primary acquired nasolacrimal duct obstruction and other new indications
ng dannysiuchun	China:Tung Wah Eastern Hosp, Dept Ophthalmol, Hong Kong, Hong Kong,Peoples R China. 	INTERNATIONAL JOURNAL OF OPHTHALMOLOGY	Clinicopathological survey of 23 patients with lacrimal fossa lesions in Hong Kong
pan zhiqiang	China:Capital Med Univ, Beijing Ophthalmol & Visual Sci Key Lab, Beijing Tongren Eye Ctr, Beijing Tongren Hosp, Beijing,Peoples R China. Capital Medical University	CORNEA	A New Nonhuman Primate Model of Severe Dry Eye
parsa leili	China:Hebei Med Univ, Hosp 3, Dept Ophthalmol, Shijiazhuang, Hebei,Peoples R China. Hebei Medical University	INVESTIGATIVE OPHTHALMOLOGY & VISUAL SCIENCE	Duct System of the Rabbit Lacrimal Gland: Structural Characteristics and Role in Lacrimal Secretion
pei chonggang	China:Nanchang Univ, Dept Ophthalmol, Affiliated Hosp 1, Nanchang 330006, Jiangxi,Peoples R China. Nanchang University	INTERNATIONAL JOURNAL OF OPHTHALMOLOGY	Aerocyst urethral catheter insertion compared to expansion sponges application in external dacryocystorhinostomy
peng jun	China:Nanhua Univ, Sch Med, Hengyang 421001, Hunan,Peoples R China. 	INTERNATIONAL JOURNAL OF OPHTHALMOLOGY	Effects of extract of Buddleja officinalis on partial inflammation of lacrimal gland in castrated rabbits with dry eye
peng qinghua	China:Hunan Univ Tradit Chinese Med, Affiliated Hosp 1, Dept Ophthalmol, Changsha 410007, Hunan,Peoples R China. 	INTERNATIONAL JOURNAL OF OPHTHALMOLOGY	Effects of extract of Buddleja officinalis on partial inflammation of lacrimal gland in castrated rabbits with dry eye
peng qinghua	China:Hunan Univ Tradit Chinese Med, Affiliated Hosp 1, Dept Ophthalmol, Changsha 410007, Hunan,Peoples R China. 	INTERNATIONAL JOURNAL OF OPHTHALMOLOGY	Effects of extract of Buddleja officinalis eye drops on androgen receptors of lacrimal gland cells of castrated rats with dry eye
peng qinghua	China:Hunan Univ Tradit Chinese Med, Affiliated Hosp 1, Dept Ophthalmol, Changsha 410007, Hunan,Peoples R China. 	INTERNATIONAL JOURNAL OF OPHTHALMOLOGY	Effect of Buddleia flavonoids drug -containing plasma on the expression of STAT1 phosphoprotein in lacrimal gland epithelial cells in vitro
pong pong	China:Chinese Univ Hong Kong, Dept Ophthalmol & Visual Sci, Hong Kong Eye Hosp, Kowloon, Hong Kong,Peoples R China. Chinese University of Hong Kong	ARCHIVES OF OPHTHALMOLOGY	Association of Hemopexin in Tear Film and Conjunctival Macrophages With Vernal Keratoconjunctivitis
poon poon	China:Chinese Univ Hong Kong, Prince Wales Hosp, Dept Paediat, Shatin, Hong Kong,Peoples R China. Chinese University of Hong KongPrince of Wales Hospital	ARCHIVES OF OPHTHALMOLOGY	Association of Hemopexin in Tear Film and Conjunctival Macrophages With Vernal Keratoconjunctivitis
qian jiang	China:Fudan Univ, Dept Ophthalmol, Eye & ENT Hosp, Shanghai 200433,Peoples R China. Fudan University	CURRENT EYE RESEARCH	Histopathology and Immunohistochemical Profile in Idiopathic Dacryoadenitis
qian jiang	China:Fudan Univ, Dept Ophthalmol, Eye & ENT Hosp, Shanghai 200433,Peoples R China. Fudan University	CURRENT EYE RESEARCH	Expression of Interleukin-17 in Autoimmune Dacryoadenitis in MRL/lpr Mice
qian jiang	China:Fudan Univ, Dept Ophthalmol, Eye & ENT Hosp, Shanghai 200433,Peoples R China. Fudan University	INTERNATIONAL JOURNAL OF OPHTHALMOLOGY	Space-occupying lesions of the lacrimal gland at one tertiary eye center in China: a retrospective clinical study of 95 patients
qian zhuyun	China:Shanghai Jiao Tong Univ, Sch Med, Dept Ophthalmol, Shanghai Peoples Hosp 9, Shanghai 200011,Peoples R China. Shanghai Jiao Tong University	JOURNAL OF OCULAR PHARMACOLOGY AND THERAPEUTICS	Clinical Outcomes of Dacryocystorhinostomy With or Without Intraoperative Use of Mitomycin C: A Systematic Review and Meta-Analysis
qin wei	China:Third Mil Med Univ, SW Eye Hosp, Southwest Hosp, Chongqing 400038,Peoples R China. Third Military Medical University	EUROPEAN JOURNAL OF OPHTHALMOLOGY	Adenoid cystic carcinoma of the lacrimal gland: CT and MRI findings
qin yi	China:Capital Med Univ, Beijing Ophthalmol & Visual Sci Key Lab, Beijing Tongren Eye Ctr, Beijing Tongren Hosp, Beijing,Peoples R China. Capital Medical University	CORNEA	A New Nonhuman Primate Model of Severe Dry Eye
qiu xiaodi	China:Fudan Univ, Eye Ear Nose & Throat Hosp, Dept Ophthalmol, Shanghai 200031,Peoples R China. Fudan University	CURRENT EYE RESEARCH	Efficacy of Acupuncture and Identification of Tear Protein Expression Changes Using iTRAQ Quantitative Proteomics in Rabbits
qu j	China:Wenzhou Med Coll, Hosp Eye, Dept Orbital & Oculoplasty Surg, Wenzhou City 325027, Zhejiang,Peoples R China. Wenzhou Medical University	EYE	Effects of Merogel coverage on wound healing and ostial patency in endonasal endoscopic dacryocystorhinostomy for primary chronic dacryocystitis
qu j	China:Wenzhou Med Coll, Hosp Eye, Dept Orbital & Oculoplasty Surg, Wenzhou City 325027, Zhejiang,Peoples R China. Wenzhou Medical University	OPHTHALMOLOGY	Primary Treatment of Acute Dacryocystitis by Endoscopic Dacryocystorhinostomy with Silicone Intubation Guided by a Soft Probe
qu j	China:Wenzhou Med Coll, Hosp Eye, Dept Orbital & Oculoplasty Surg, Wenzhou City 325027, Zhejiang,Peoples R China. Wenzhou Medical University	INVESTIGATIVE OPHTHALMOLOGY & VISUAL SCIENCE	A murine model of dry eye induced by an intelligently controlled environmental system
qu yangluowa	China:Fujian Prov Key Lab Ophthalmol & Visual Sci, Xiamen, Fujian,Peoples R China. 	PLOS ONE	Air Exposure Induced Characteristics of Dry Eye in Conjunctival Tissue Culture
rao srinivask	China:Chinese Univ Hong Kong, Dept Ophthalmol & Visual Sci, Hong Kong Eye Hosp, Kowloon, Hong Kong,Peoples R China. Chinese University of Hong Kong	ARCHIVES OF OPHTHALMOLOGY	Association of Hemopexin in Tear Film and Conjunctival Macrophages With Vernal Keratoconjunctivitis
shao yi	China:Nanchang Univ, Dept Ophthalmol, Affiliated Hosp 1, Nanchang 330006, Jiangxi,Peoples R China. Nanchang University	INTERNATIONAL JOURNAL OF OPHTHALMOLOGY	Aerocyst urethral catheter insertion compared to expansion sponges application in external dacryocystorhinostomy
shen meixiao	China:Wenzhou Med Coll, Sch Ophthalmol & Optometry, Wenzhou 325027, Zhejiang,Peoples R China. Wenzhou Medical University	OPTOMETRY AND VISION SCIENCE	Age-Related Changes in Tear Menisci Imaged by Optical Coherence Tomography
shi jieliang	China:Wenzhou Med Coll, Affiliated Eye Hosp, Sch Ophthalmol & Optometry, Wenzhou 325027, Zhejiang,Peoples R China. Wenzhou Medical University	OPHTHALMIC EPIDEMIOLOGY	A Meta-analysis of Primary External Dacryocystorhinostomy With and Without Mitomycin C
shi jitong	China:Capital Med Univ, Beijing Tongren Hosp, Beijing Tongren Eye Ctr, Beijing Inst Ophthalmol, Beijing,Peoples R China. Capital Medical University	GRAEFES ARCHIVE FOR CLINICAL AND EXPERIMENTAL OPHTHALMOLOGY	Epithelial tumors of the lacrimal gland in the Chinese: a clinicopathologic study of 298 patients
song xiujun	China:Hebei Med Univ, Hosp 3, Dept Ophthalmol, Shijiazhuang 050011,Peoples R China. Hebei Medical University	INVESTIGATIVE OPHTHALMOLOGY & VISUAL SCIENCE	The Effects of Estrogen and Androgen on Tear Secretion and Matrix Metalloproteinase-2 Expression in Lacrimal Glands of Ovariectomized Rats
sui g	China:Jilin Univ, Dept Ophthalmol, Bethune Hosp 2, Changchun 130023,Peoples R China. Jilin University	EYE	Two-step retrograde closed stenting: a novel method for treating canalicular lacerations in Chinese patients
sun song	China:Nanjing Med Univ, Wuxi Hosp 2, Dept Ophthalmol, Wuxi 214002, Jiangsu,Peoples R China. Nanjing Medical University	OPTOMETRY AND VISION SCIENCE	Sebaceous Carcinoma of Lacrimal Caruncle in a Chinese Patient
sun x	China:Tongji Univ, Dept Ophthalmol, Tongji Hosp, Sch Med, Shanghai 200092,Peoples R China. Tongji University	EYE	Two-step retrograde closed stenting: a novel method for treating canalicular lacerations in Chinese patients
sun xianli	China:Capital Med Univ, Beijing Tongren Hosp, Beijing Tongren Eye Ctr, Beijing Inst Ophthalmol, Beijing,Peoples R China. Capital Medical University	GRAEFES ARCHIVE FOR CLINICAL AND EXPERIMENTAL OPHTHALMOLOGY	Epithelial tumors of the lacrimal gland in the Chinese: a clinicopathologic study of 298 patients
sun xinghuai	China:Fudan Univ, Eye Ear Nose & Throat Hosp, Dept Ophthalmol, Shanghai 200031,Peoples R China. Fudan University	CURRENT EYE RESEARCH	Efficacy of Acupuncture and Identification of Tear Protein Expression Changes Using iTRAQ Quantitative Proteomics in Rabbits
sun yanli	China:Wenzhou Med Coll, Affiliated Eye Hosp, Sch Ophthalmol & Optometry, Wenzhou 325027, Zhejiang,Peoples R China. Wenzhou Medical University	OPHTHALMIC EPIDEMIOLOGY	A Meta-analysis of Primary External Dacryocystorhinostomy With and Without Mitomycin C
sze sze	China:Hosp Author Ophthalm Serv, Hong Kong Eye Hosp, Hong Kong, Hong Kong,Peoples R China. 	OPHTHALMIC PLASTIC AND RECONSTRUCTIVE SURGERY	Limited Nasal Septoplasty by Ophthalmologists During Endonasal Dacryocystorhinostomy: Is It Safe?
tan hanyu	China:Hunan Univ Tradit Chinese Med, Affiliated Hosp 1, Dept Ophthalmol, Changsha 410007, Hunan,Peoples R China. 	INTERNATIONAL JOURNAL OF OPHTHALMOLOGY	Effects of extract of Buddleja officinalis on partial inflammation of lacrimal gland in castrated rabbits with dry eye
tan hanyu	China:Hunan Univ Tradit Chinese Med, Affiliated Hosp 1, Dept Ophthalmol, Changsha 410007, Hunan,Peoples R China. 	INTERNATIONAL JOURNAL OF OPHTHALMOLOGY	Effects of extract of Buddleja officinalis eye drops on androgen receptors of lacrimal gland cells of castrated rats with dry eye
tan xiaobo	China:Capital Med Univ, Beijing Ophthalmol & Visual Sci Key Lab, Beijing Tongren Eye Ctr, Beijing Tongren Hosp, Beijing,Peoples R China. Capital Medical University	CORNEA	A New Nonhuman Primate Model of Severe Dry Eye
tang ls	China:Cent S Univ, Xiangya Hosp 2, Dept Ophthalmol, Changsha 410011,Peoples R China. Central South University	OPHTHALMOLOGICA	Adult nasolacrimal sac mucocele
tang lingyin	China:Chinese Univ Hong Kong, Prince Wales Hosp, Dept Obstet & Gynaecol, Shatin, Hong Kong,Peoples R China. Chinese University of Hong KongPrince of Wales Hospital	ARCHIVES OF OPHTHALMOLOGY	Association of Hemopexin in Tear Film and Conjunctival Macrophages With Vernal Keratoconjunctivitis
tang s	China:Tongji Univ, Dept Ophthalmol, Tongji Hosp, Sch Med, Shanghai 200092,Peoples R China. Tongji University	EYE	Two-step retrograde closed stenting: a novel method for treating canalicular lacerations in Chinese patients
tao aizhu	China:Wenzhou Med Coll, Sch Ophthalmol & Optometry, Wenzhou 325027, Zhejiang,Peoples R China. Wenzhou Medical University	OPTOMETRY AND VISION SCIENCE	Age-Related Changes in Tear Menisci Imaged by Optical Coherence Tomography
tao hai	China:Armed Police Gen Hosp China, Lacrimal Ctr Ophthalmol, Beijing 100039,Peoples R China. 	INTERNATIONAL JOURNAL OF OPHTHALMOLOGY	Diagnosis of lacrimal canalicular diseases using ultrasound biomicroscopy: a preliminary study
tong nvxia	China:Zhejiang Univ, Sch Med, Affiliated Hosp 2, Ctr Eye, Hangzhou 310009, Zhejiang,Peoples R China. Zhejiang University	OPHTHALMIC PLASTIC AND RECONSTRUCTIVE SURGERY	Use of Crawford Tube for Chronic Suppurative Lacrimal Canaliculitis
tu y	China:Wenzhou Med Coll, Hosp Eye, Dept Orbital & Oculoplasty Surg, Wenzhou City 325027, Zhejiang,Peoples R China. Wenzhou Medical University	EYE	Effects of Merogel coverage on wound healing and ostial patency in endonasal endoscopic dacryocystorhinostomy for primary chronic dacryocystitis
tu y	China:Wenzhou Med Coll, Hosp Eye, Dept Orbital & Oculoplasty Surg, Wenzhou City 325027, Zhejiang,Peoples R China. Wenzhou Medical University	OPHTHALMOLOGY	Primary Treatment of Acute Dacryocystitis by Endoscopic Dacryocystorhinostomy with Silicone Intubation Guided by a Soft Probe
tu y	China:Wenzhou Med Coll, Hosp Eye, Dept Orbital & Oculoplasty Surg, Wenzhou City 325027, Zhejiang,Peoples R China. Wenzhou Medical University	INTERNATIONAL JOURNAL OF OPHTHALMOLOGY	New mucosal flap modification for endonasal endoscopic dacryocystorhinostomy in Asians
wan pengxia	China:Sun Yat Sen Univ, Zhongshan Ophthalm Ctr, State Key Lab Ophthalmol, Guangzhou 510060, Guangdong,Peoples R China. Sun Yat Sen University	BRITISH JOURNAL OF OPHTHALMOLOGY	A novel procedure for treating canalicular obstruction by re-canaliculisation and bicanalicular intubation
wang chichiu	China:Chinese Univ Hong Kong, Prince Wales Hosp, Dept Obstet & Gynaecol, Shatin, Hong Kong,Peoples R China. Chinese University of Hong KongPrince of Wales Hospital	ARCHIVES OF OPHTHALMOLOGY	Association of Hemopexin in Tear Film and Conjunctival Macrophages With Vernal Keratoconjunctivitis
wang fang	China:Guiyang Univ Tradit Chinese Med, Dept Ophthalmol, Affiliated Hosp 2, Guiyang 550003, Guizhou Prov,Peoples R China. 	INTERNATIONAL JOURNAL OF OPHTHALMOLOGY	Effect of Buddleia flavonoids drug -containing plasma on the expression of STAT1 phosphoprotein in lacrimal gland epithelial cells in vitro
wang guiying	China:Hebei Med Univ, Hosp 4, Shijiazhuang 050011,Peoples R China. Hebei Medical University	INVESTIGATIVE OPHTHALMOLOGY & VISUAL SCIENCE	The Effects of Estrogen and Androgen on Tear Secretion and Matrix Metalloproteinase-2 Expression in Lacrimal Glands of Ovariectomized Rats
wang jinghui	China:Beijing Tongren Hosp, Beijing Tongren Eye Ctr, Beijing 300070,Peoples R China. Capital Medical University	JOURNAL OF AAPOS	Surgical management of large-angle incomitant strabismus in patients with oculomotor nerve palsy
wang l	China:Sun Yat Sen Univ, Zhongshan Ophthalm Ctr, State Key Lab Ophthalmol, Guangzhou 510060, Guangdong,Peoples R China. Sun Yat Sen University	BRITISH JOURNAL OF OPHTHALMOLOGY	A simple and evolutional approach proven to recanalise the nasolacrimal duct obstruction
wang peng	China:Armed Police Gen Hosp China, Lacrimal Ctr Ophthalmol, Beijing 100039,Peoples R China. 	INTERNATIONAL JOURNAL OF OPHTHALMOLOGY	Diagnosis of lacrimal canalicular diseases using ultrasound biomicroscopy: a preliminary study
wang qinmei	China:Hosp Eye, Wenzhou Med Coll, Wenzhou City 325027,Peoples R China. Wenzhou Medical University	OPHTHALMOLOGY	Primary Treatment of Acute Dacryocystitis by Endoscopic Dacryocystorhinostomy with Silicone Intubation Guided by a Soft Probe
wang qinmei	China:Hosp Eye, Wenzhou Med Coll, Wenzhou City 325027,Peoples R China. Wenzhou Medical University	INVESTIGATIVE OPHTHALMOLOGY & VISUAL SCIENCE	A murine model of dry eye induced by an intelligently controlled environmental system
wang shiming	China:Wenzhou Med Coll, Sch Ophthalmol & Optometry, Wenzhou 325027, Zhejiang,Peoples R China. Wenzhou Medical University	INVESTIGATIVE OPHTHALMOLOGY & VISUAL SCIENCE	A murine model of dry eye induced by an intelligently controlled environmental system
wang xiangning	China:Fudan Univ, Eye & ENT Hosp, Dept Ophthalmol, Shanghai 200031,Peoples R China. Fudan University	INTERNATIONAL JOURNAL OF OPHTHALMOLOGY	Space-occupying lesions of the lacrimal gland at one tertiary eye center in China: a retrospective clinical study of 95 patients
wang xiaoran	China:Sun Yat Sen Univ, Zhongshan Ophthalm Ctr, State Key Lab Ophthalmol, Guangzhou 510060, Guangdong,Peoples R China. Sun Yat Sen University	BRITISH JOURNAL OF OPHTHALMOLOGY	A novel procedure for treating canalicular obstruction by re-canaliculisation and bicanalicular intubation
wang yefei	China:Shanghai Jiao Tong Univ, Dept Ophthalmol, Shanghai Peoples Hosp 9, Sch Med, Shanghai 200011,Peoples R China. Shanghai Jiao Tong University	OPHTHALMIC PLASTIC AND RECONSTRUCTIVE SURGERY	Palpebral Lipogranuloma Caused by Transcanalicular Ointment Injection After Laser Canaliculoplasty
wang z	China:Sun Yat Sen Univ, State Key Lab Ophthalmol, Zhongshan Ophthalm Ctr, Guangzhou 510060, Guangdong,Peoples R China. Sun Yat Sen University	EYE	A modified bicanalicular intubation procedure to repair canalicular lacerations using silicone tubes
wang z	China:Sun Yat Sen Univ, State Key Lab Ophthalmol, Zhongshan Ophthalm Ctr, Guangzhou 510060, Guangdong,Peoples R China. Sun Yat Sen University	EYE	A modified bicanalicular intubation procedure to repair canalicular lacerations using silicone tubes
wang z	China:Sun Yat Sen Univ, State Key Lab Ophthalmol, Zhongshan Ophthalm Ctr, Guangzhou 510060, Guangdong,Peoples R China. Sun Yat Sen University	BRITISH JOURNAL OF OPHTHALMOLOGY	A simple and evolutional approach proven to recanalise the nasolacrimal duct obstruction
wang z	China:Sun Yat Sen Univ, State Key Lab Ophthalmol, Zhongshan Ophthalm Ctr, Guangzhou 510060, Guangdong,Peoples R China. Sun Yat Sen University	BRITISH JOURNAL OF OPHTHALMOLOGY	A novel procedure for treating canalicular obstruction by re-canaliculisation and bicanalicular intubation
wang z	China:Sun Yat Sen Univ, State Key Lab Ophthalmol, Zhongshan Ophthalm Ctr, Guangzhou 510060, Guangdong,Peoples R China. Sun Yat Sen University	BRITISH JOURNAL OF OPHTHALMOLOGY	Novel air-injection technique to locate the medial cut end of lacerated canaliculus
wang z	China:Sun Yat Sen Univ, State Key Lab Ophthalmol, Zhongshan Ophthalm Ctr, Guangzhou 510060, Guangdong,Peoples R China. Sun Yat Sen University	BRITISH JOURNAL OF OPHTHALMOLOGY	Novel air-injection technique to locate the medial cut end of lacerated canaliculus
wang z	China:Tongji Univ, Dept Ophthalmol, Tongji Hosp, Sch Med, Shanghai 200092,Peoples R China. Tongji University	EYE	Two-step retrograde closed stenting: a novel method for treating canalicular lacerations in Chinese patients
wei ruihua	China:Tianjin Med Univ, Ctr Eye, Tianjin,Peoples R China. Tianjin Medical University	CORNEA	Autoimmune Dacryoadenitis and Sialadenitis Induced in Rabbits by Intravenous Injection of Autologous Lymphocytes Activated Ex Vivo Against Lacrimal Antigens
wei ruihua	China:Tianjin Med Univ, Ctr Eye, Tianjin,Peoples R China. Tianjin Medical University	CORNEA	Changes of Chloride Channels in the Lacrimal Glands of a Rabbit Model of Sjogren Syndrome
wong achakming	China:Union Hosp, Dept Ophthalmol, Hong Kong, Hong Kong,Peoples R China. 	EYE	Comment on 'Effects of Merogel coverage on wound healing and ostial patency in endonasal endoscopic dacryocytorhinostomy for primary chronic dacryocystitis'
wong albertchakming	China:Union Hosp, Dept Ophthalmol, Hong Kong, Hong Kong,Peoples R China. 	GRAEFES ARCHIVE FOR CLINICAL AND EXPERIMENTAL OPHTHALMOLOGY	Prognostic factors for outcome of endoscopic dacryocystorhinostomy in patients with primary acquired nasolacrimal duct obstruction
wong wong	China:Hosp Author Ophthalm Serv, Hong Kong Eye Hosp, Hong Kong, Hong Kong,Peoples R China. 	OPHTHALMIC PLASTIC AND RECONSTRUCTIVE SURGERY	Limited Nasal Septoplasty by Ophthalmologists During Endonasal Dacryocystorhinostomy: Is It Safe?
wong wong	China:Hosp Author Ophthalm Serv, Hong Kong Eye Hosp, Hong Kong, Hong Kong,Peoples R China. 	OPHTHALMIC PLASTIC AND RECONSTRUCTIVE SURGERY	Balloon Dacryoplasty in Internal Ostium Stenosis After Endoscopic Dacryocystorhinostomy
wong wong	China:Hosp Author Ophthalm Serv, Hong Kong Eye Hosp, Hong Kong, Hong Kong,Peoples R China. 	CORNEA	Pediatric Ocular Surface Infections: A 5-year Review of Demographics, Clinical Features, Risk Factors, Microbiological Results, and Treatment
wong benw	China:Prince Wales Hosp, Dept Ophthalmol & Visual Sci, Hong Kong, Hong Kong,Peoples R China. Chinese University of Hong KongPrince of Wales Hospital	OPHTHALMOLOGY	Randomized Trial on Silicone Intubation in Endoscopic Mechanical Dacryocystorhinostomy (SEND) for Primary Nasolacrimal Duct Obstruction
wu dali	China:Hunan Univ Tradit Chinese Med, Affiliated Hosp 1, Dept Ophthalmol, Changsha 410007, Hunan,Peoples R China. 	INTERNATIONAL JOURNAL OF OPHTHALMOLOGY	Effects of extract of Buddleja officinalis on partial inflammation of lacrimal gland in castrated rabbits with dry eye
wu huping	China:Xiamen Univ, Affiliated Xiamen Eye Ctr, Xiamen, Fujian,Peoples R China. Xiamen University	PLOS ONE	Air Exposure Induced Characteristics of Dry Eye in Conjunctival Tissue Culture
wu quanlong	China:Hunan Univ Tradit Chinese Med, Affiliated Hosp 1, Dept Ophthalmol, Changsha 410007, Hunan,Peoples R China. 	INTERNATIONAL JOURNAL OF OPHTHALMOLOGY	Effects of extract of Buddleja officinalis on partial inflammation of lacrimal gland in castrated rabbits with dry eye
wu quanlong	China:Hunan Univ Tradit Chinese Med, Affiliated Hosp 1, Dept Ophthalmol, Changsha 410007, Hunan,Peoples R China. 	INTERNATIONAL JOURNAL OF OPHTHALMOLOGY	Effects of extract of Buddleja officinalis eye drops on androgen receptors of lacrimal gland cells of castrated rats with dry eye
wu quanlong	China:Hunan Univ Tradit Chinese Med, Affiliated Hosp 1, Dept Ophthalmol, Changsha 410007, Hunan,Peoples R China. 	INTERNATIONAL JOURNAL OF OPHTHALMOLOGY	Effect of Buddleia flavonoids drug -containing plasma on the expression of STAT1 phosphoprotein in lacrimal gland epithelial cells in vitro
wu w	China:Wenzhou Med Coll, Hosp Eye, Dept Orbital & Oculoplasty Surg, Wenzhou City 325027, Zhejiang,Peoples R China. Wenzhou Medical University	EYE	Effects of Merogel coverage on wound healing and ostial patency in endonasal endoscopic dacryocystorhinostomy for primary chronic dacryocystitis
wu w	China:Wenzhou Med Coll, Hosp Eye, Dept Orbital & Oculoplasty Surg, Wenzhou City 325027, Zhejiang,Peoples R China. Wenzhou Medical University	OPHTHALMOLOGY	Primary Treatment of Acute Dacryocystitis by Endoscopic Dacryocystorhinostomy with Silicone Intubation Guided by a Soft Probe
wu w	China:Wenzhou Med Coll, Hosp Eye, Dept Orbital & Oculoplasty Surg, Wenzhou City 325027, Zhejiang,Peoples R China. Wenzhou Medical University	INTERNATIONAL JOURNAL OF OPHTHALMOLOGY	New mucosal flap modification for endonasal endoscopic dacryocystorhinostomy in Asians
wu xr	China:Cent S Univ, Xiangya Hosp 2, Dept Ophthalmol, Changsha 410011,Peoples R China. Central South University	OPHTHALMOLOGICA	Adult nasolacrimal sac mucocele
wu xiao	China:Beijing Tongren Hosp, Beijing Tongren Eye Ctr, Beijing 300070,Peoples R China. Capital Medical University	JOURNAL OF AAPOS	Surgical management of large-angle incomitant strabismus in patients with oculomotor nerve palsy
wu yalan	China:Chinese Acad Sci, Lab Clin Visual Sci, Inst Hlth Sci, Shanghai Inst Biol Sci, Shanghai 200025,Peoples R China. Chinese Academy of SciencesShanghai Institutes for Biological Sciences	GRAEFES ARCHIVE FOR CLINICAL AND EXPERIMENTAL OPHTHALMOLOGY	Selecting highly sensitive non-obese diabetic mice for improving the study of Sjogren's syndrome
xiao caiwen	China:Shanghai Jiao Tong Univ, Dept Ophthalmol, Shanghai Peoples Hosp 9, Sch Med, Shanghai 200011,Peoples R China. Shanghai Jiao Tong University	OPHTHALMIC PLASTIC AND RECONSTRUCTIVE SURGERY	Palpebral Lipogranuloma Caused by Transcanalicular Ointment Injection After Laser Canaliculoplasty
xiao jianhui	China:Sun Yat Sen Univ, Zhongshan Ophthalm Ctr, State Key Lab Ophthalmol, Guangzhou 510060, Guangdong,Peoples R China. Sun Yat Sen University	BRITISH JOURNAL OF OPHTHALMOLOGY	A novel procedure for treating canalicular obstruction by re-canaliculisation and bicanalicular intubation
xiao my	China:Cent S Univ, Xiangya Hosp 2, Dept Ophthalmol, Changsha 410011,Peoples R China. Central South University	OPHTHALMOLOGICA	Adult nasolacrimal sac mucocele
xiao tianlin	China:Hosp Eye, Wenzhou Med Coll, Wenzhou City 325027,Peoples R China. Wenzhou Medical University	OPHTHALMOLOGY	Primary Treatment of Acute Dacryocystitis by Endoscopic Dacryocystorhinostomy with Silicone Intubation Guided by a Soft Probe
xiao weibao	China:Fudan Univ, Dept Ophthalmol, Huashan Hosp, Sch Med, Shanghai 200040,Peoples R China. Fudan University	GRAEFES ARCHIVE FOR CLINICAL AND EXPERIMENTAL OPHTHALMOLOGY	Selecting highly sensitive non-obese diabetic mice for improving the study of Sjogren's syndrome
xu cc	China:Sun Yat Sen Univ, Ocular Surface Ctr, Zhongshan Ophthalm Ctr, State Key Lab Ophthalmol, Guangzhou,Peoples R China. Sun Yat Sen University	EXPERIMENTAL EYE RESEARCH	MUC19 expression in human ocular surface and lacrimal gland and its alteration in Sjogren syndrome patients
xu guotong	China:Chinese Acad Sci, Lab Clin Visual Sci, Inst Hlth Sci, Shanghai Inst Biol Sci, Shanghai 200025,Peoples R China. Chinese Academy of SciencesShanghai Institutes for Biological Sciences	GRAEFES ARCHIVE FOR CLINICAL AND EXPERIMENTAL OPHTHALMOLOGY	Selecting highly sensitive non-obese diabetic mice for improving the study of Sjogren's syndrome
xu jianping	China:Capital Med Univ, Beijing Tongren Hosp, Beijing Tongren Eye Ctr, Beijing Inst Ophthalmol, Beijing,Peoples R China. Capital Medical University	GRAEFES ARCHIVE FOR CLINICAL AND EXPERIMENTAL OPHTHALMOLOGY	Epithelial tumors of the lacrimal gland in the Chinese: a clinicopathologic study of 298 patients
xu ling	China:Hubei Univ Med, Taihe Hosp, Dept Ophthalmol, Shijiazhuang, Hubei,Peoples R China. 	PLOS ONE	Efficacy of Mitomycin C in Endoscopic Dacryocystorhinostomy: A Systematic Review and Meta-Analysis
xu liping	China:Armed Police Gen Hosp China, Lacrimal Ctr Ophthalmol, Beijing 100039,Peoples R China. 	INTERNATIONAL JOURNAL OF OPHTHALMOLOGY	Diagnosis of lacrimal canalicular diseases using ultrasound biomicroscopy: a preliminary study
xu wen	China:Zhejiang Univ, Sch Med, Affiliated Hosp 2, Ctr Eye, Hangzhou 310009, Zhejiang,Peoples R China. Zhejiang University	OPHTHALMIC PLASTIC AND RECONSTRUCTIVE SURGERY	Use of Crawford Tube for Chronic Suppurative Lacrimal Canaliculitis
yam yam	China:Chinese Univ Hong Kong, Dept Ophthalmol & Visual Sci, Hong Kong, Hong Kong,Peoples R China. Chinese University of Hong Kong	JOURNAL OF AAPOS	Bilateral canalicular and nasolacrimal duct obstruction in congenital erosive and vesicular dermatosis: a case report and review of the literature
yan jianhua	China:Sun Yat Sen Univ, Zhongshan Ophthalm Ctr, State Key Lab Ophthalmol, Guangzhou 510060, Guangdong,Peoples R China. Sun Yat Sen University	GRAEFES ARCHIVE FOR CLINICAL AND EXPERIMENTAL OPHTHALMOLOGY	Metastatic orbital tumors in southern China during an 18-year period
yan w	China:Wenzhou Med Coll, Hosp Eye, Dept Orbital & Oculoplasty Surg, Wenzhou City 325027, Zhejiang,Peoples R China. Wenzhou Medical University	EYE	Effects of Merogel coverage on wound healing and ostial patency in endonasal endoscopic dacryocystorhinostomy for primary chronic dacryocystitis
yan w	China:Wenzhou Med Coll, Hosp Eye, Dept Orbital & Oculoplasty Surg, Wenzhou City 325027, Zhejiang,Peoples R China. Wenzhou Medical University	OPHTHALMOLOGY	Primary Treatment of Acute Dacryocystitis by Endoscopic Dacryocystorhinostomy with Silicone Intubation Guided by a Soft Probe
yang lu	China:Nanchang Univ, Dept Ophthalmol, Affiliated Hosp 1, Nanchang 330006, Jiangxi,Peoples R China. Nanchang University	INTERNATIONAL JOURNAL OF OPHTHALMOLOGY	Aerocyst urethral catheter insertion compared to expansion sponges application in external dacryocystorhinostomy
yang yuan	China:Hosp Eye, Wenzhou Med Coll, Wenzhou City 325027,Peoples R China. Wenzhou Medical University	OPHTHALMOLOGY	Primary Treatment of Acute Dacryocystitis by Endoscopic Dacryocystorhinostomy with Silicone Intubation Guided by a Soft Probe
yao xiaolei	China:Guiyang Univ Tradit Chinese Med, Dept Ophthalmol, Affiliated Hosp 2, Guiyang 550003, Guizhou Prov,Peoples R China. 	INTERNATIONAL JOURNAL OF OPHTHALMOLOGY	Effect of Buddleia flavonoids drug -containing plasma on the expression of STAT1 phosphoprotein in lacrimal gland epithelial cells in vitro
yao xiaolei	China:Hunan Univ Tradit Chinese Med, Affiliated Hosp 1, Dept Ophthalmol, Changsha 410007, Hunan,Peoples R China. 	INTERNATIONAL JOURNAL OF OPHTHALMOLOGY	Effects of extract of Buddleja officinalis on partial inflammation of lacrimal gland in castrated rabbits with dry eye
yao xiaolei	China:Hunan Univ Tradit Chinese Med, Affiliated Hosp 1, Dept Ophthalmol, Changsha 410007, Hunan,Peoples R China. 	INTERNATIONAL JOURNAL OF OPHTHALMOLOGY	Effects of extract of Buddleja officinalis eye drops on androgen receptors of lacrimal gland cells of castrated rats with dry eye
yau kin	China:Tung Wah Eastern Hosp, Dept Ophthalmol, Hong Kong, Hong Kong,Peoples R China. 	INTERNATIONAL JOURNAL OF OPHTHALMOLOGY	Clinicopathological survey of 23 patients with lacrimal fossa lesions in Hong Kong
ye wen	China:Fudan Univ, Dept Ophthalmol, Huashan Hosp, Sch Med, Shanghai 200040,Peoples R China. Fudan University	GRAEFES ARCHIVE FOR CLINICAL AND EXPERIMENTAL OPHTHALMOLOGY	Selecting highly sensitive non-obese diabetic mice for improving the study of Sjogren's syndrome
yin zhengqin	China:Third Mil Med Univ, SW Eye Hosp, Southwest Hosp, Chongqing 400038,Peoples R China. Third Military Medical University	EUROPEAN JOURNAL OF OPHTHALMOLOGY	Adenoid cystic carcinoma of the lacrimal gland: CT and MRI findings
young alvin	China:Prince Wales Hosp, Dept Ophthalmol & Visual Sci, Hong Kong, Hong Kong,Peoples R China. Chinese University of Hong KongPrince of Wales Hospital	OPHTHALMOLOGY	Randomized Trial on Silicone Intubation in Endoscopic Mechanical Dacryocystorhinostomy (SEND) for Primary Nasolacrimal Duct Obstruction
yu df	China:Sun Yat Sen Univ, Ocular Surface Ctr, Zhongshan Ophthalm Ctr, State Key Lab Ophthalmol, Guangzhou,Peoples R China. Sun Yat Sen University	EXPERIMENTAL EYE RESEARCH	MUC19 expression in human ocular surface and lacrimal gland and its alteration in Sjogren syndrome patients
yu guangyan	China:Peking Univ, Hosp Stomatol, Dept Oral & Maxillofacial Surg, Beijing 100081,Peoples R China. Peking University	CORNEA	Establishment of a Rabbit Model for Keratoconjunctivitis Sicca
yu guangyan	China:Peking Univ, Hosp Stomatol, Dept Oral & Maxillofacial Surg, Beijing 100081,Peoples R China. Peking University	INVESTIGATIVE OPHTHALMOLOGY & VISUAL SCIENCE	Treatment of Severe Keratoconjunctivitis Sicca by Parotid Duct Transposition after Tympanic Neurectomy in Rabbits
yu jiguo	China:Wenzhou Med Coll, Affiliated Eye Hosp, Sch Ophthalmol & Optometry, Wenzhou 325027, Zhejiang,Peoples R China. Wenzhou Medical University	OPHTHALMIC EPIDEMIOLOGY	A Meta-analysis of Primary External Dacryocystorhinostomy With and Without Mitomycin C
yu yao	China:So Med Univ, Dept Endocrinol, Hosp Nanchang 3, Affiliated Nanchang Hosp, Nanchang 330009, Jiangxi,Peoples R China. Southern Medical University - China	INTERNATIONAL JOURNAL OF OPHTHALMOLOGY	Aerocyst urethral catheter insertion compared to expansion sponges application in external dacryocystorhinostomy
yuan yifei	China:Fudan Univ, Eye & ENT Hosp, Dept Ophthalmol, Shanghai 086200031,Peoples R China. Fudan University	CURRENT EYE RESEARCH	Expression of Interleukin-17 in Autoimmune Dacryoadenitis in MRL/lpr Mice
yuan yifei	China:Fudan Univ, Eye & ENT Hosp, Dept Ophthalmol, Shanghai 086200031,Peoples R China. Fudan University	INTERNATIONAL JOURNAL OF OPHTHALMOLOGY	Space-occupying lesions of the lacrimal gland at one tertiary eye center in China: a retrospective clinical study of 95 patients
yuen yuen	China:Chinese Univ Hong Kong, Hong Kong Eye Hosp, Univ Eye Ctr, Dept Ophthalmol & Visual Sci, Kowloon, Hong Kong,Peoples R China. Chinese University of Hong Kong	OPHTHALMIC PLASTIC AND RECONSTRUCTIVE SURGERY	Limited Nasal Septoplasty by Ophthalmologists During Endonasal Dacryocystorhinostomy: Is It Safe?
yuen yuen	China:Chinese Univ Hong Kong, Hong Kong Eye Hosp, Univ Eye Ctr, Dept Ophthalmol & Visual Sci, Kowloon, Hong Kong,Peoples R China. Chinese University of Hong Kong	OPHTHALMIC PLASTIC AND RECONSTRUCTIVE SURGERY	Balloon Dacryoplasty in Internal Ostium Stenosis After Endoscopic Dacryocystorhinostomy
zeng jie	China:Capital Med Univ, Beijing Tongren Hosp, Beijing Tongren Eye Ctr, Beijing Inst Ophthalmol, Beijing,Peoples R China. Capital Medical University	GRAEFES ARCHIVE FOR CLINICAL AND EXPERIMENTAL OPHTHALMOLOGY	Epithelial tumors of the lacrimal gland in the Chinese: a clinicopathologic study of 298 patients
zeng s	China:Sun Yat Sen Univ, State Key Lab Ophthalmol, Zhongshan Ophthalm Ctr, Guangzhou 510060, Guangdong,Peoples R China. Sun Yat Sen University	EYE	A modified bicanalicular intubation procedure to repair canalicular lacerations using silicone tubes
zhang fanghua	China:Beijing Tongren Hosp, Beijing Tongren Eye Ctr, Beijing 300070,Peoples R China. Capital Medical University	JOURNAL OF AAPOS	Surgical management of large-angle incomitant strabismus in patients with oculomotor nerve palsy
zhang h	China:Sun Yat Sen Univ, Ocular Surface Ctr, Zhongshan Ophthalm Ctr, State Key Lab Ophthalmol, Guangzhou,Peoples R China. Sun Yat Sen University	EXPERIMENTAL EYE RESEARCH	MUC19 expression in human ocular surface and lacrimal gland and its alteration in Sjogren syndrome patients
zhang jiayu	China:Wenzhou Med Coll, Ruian Peoples Hosp, Affiliated Hosp 3, Wenzhou 325000, Zhejiang,Peoples R China. Wenzhou Medical University	CANADIAN JOURNAL OF OPHTHALMOLOGY-JOURNAL CANADIEN D OPHTALMOLOGIE	A meta-analysis of primary dacryocystorhinostomy with and without silicone intubation
zhang jingfa	China:Chinese Acad Sci, Lab Clin Visual Sci, Inst Hlth Sci, Shanghai Inst Biol Sci, Shanghai 200025,Peoples R China. Chinese Academy of SciencesShanghai Institutes for Biological Sciences	GRAEFES ARCHIVE FOR CLINICAL AND EXPERIMENTAL OPHTHALMOLOGY	Selecting highly sensitive non-obese diabetic mice for improving the study of Sjogren's syndrome
zhang jingna	China:Wenzhou Med Coll, Sch Ophthalmol & Optometry, Wenzhou 325027, Zhejiang,Peoples R China. Wenzhou Medical University	INVESTIGATIVE OPHTHALMOLOGY & VISUAL SCIENCE	A murine model of dry eye induced by an intelligently controlled environmental system
zhang jingrong	China:Hunan Univ Tradit Chinese Med, Key Discipline Ophthalmol, Affiliated Hosp 1, Key Discipline Tradit Chinese Ophthalmol, Changsha 410007, Hunan,Peoples R China. 	INTERNATIONAL JOURNAL OF OPHTHALMOLOGY	Effects of extract of Buddleja officinalis eye drops on androgen receptors of lacrimal gland cells of castrated rats with dry eye
zhang rui	China:Fudan Univ, Dept Ophthalmol, Eye & ENT Hosp, Shanghai 200433,Peoples R China. Fudan University	CURRENT EYE RESEARCH	Histopathology and Immunohistochemical Profile in Idiopathic Dacryoadenitis
zhang rui	China:Fudan Univ, Dept Ophthalmol, Eye & ENT Hosp, Shanghai 200433,Peoples R China. Fudan University	CURRENT EYE RESEARCH	Expression of Interleukin-17 in Autoimmune Dacryoadenitis in MRL/lpr Mice
zhang rui	China:Fudan Univ, Dept Ophthalmol, Eye & ENT Hosp, Shanghai 200433,Peoples R China. Fudan University	INTERNATIONAL JOURNAL OF OPHTHALMOLOGY	Space-occupying lesions of the lacrimal gland at one tertiary eye center in China: a retrospective clinical study of 95 patients
zhang shihua	China:Huizhou First Hosp, Huizhou 516001,Peoples R China. 	BMC OPHTHALMOLOGY	Establishment of the mild, moderate and severe dry eye models using three methods in rabbits
zhang xiaobo	China:Wenzhou Med Coll, Sch Ophthalmol & Optometry, Wenzhou 325027, Zhejiang,Peoples R China. Wenzhou Medical University	INVESTIGATIVE OPHTHALMOLOGY & VISUAL SCIENCE	A murine model of dry eye induced by an intelligently controlled environmental system
zhang yanqing	China:Fudan Univ, Eye & ENT Hosp, Dept Ophthalmol, Shanghai 200031,Peoples R China. Fudan University	INTERNATIONAL JOURNAL OF OPHTHALMOLOGY	Space-occupying lesions of the lacrimal gland at one tertiary eye center in China: a retrospective clinical study of 95 patients
zhang yidan	China:Shanghai Jiao Tong Univ, Sch Med, Dept Ophthalmol, Shanghai Peoples Hosp 9, Shanghai 200011,Peoples R China. Shanghai Jiao Tong University	JOURNAL OF OCULAR PHARMACOLOGY AND THERAPEUTICS	Clinical Outcomes of Dacryocystorhinostomy With or Without Intraoperative Use of Mitomycin C: A Systematic Review and Meta-Analysis
zhang yingnan	China:Capital Med Univ, Beijing Ophthalmol & Visual Sci Key Lab, Beijing Tongren Eye Ctr, Beijing Tongren Hosp, Beijing,Peoples R China. Capital Medical University	CORNEA	A New Nonhuman Primate Model of Severe Dry Eye
zhang zhengwei	China:Nanjing Med Univ, Wuxi Hosp 2, Dept Ophthalmol, Wuxi 214002, Jiangsu,Peoples R China. Nanjing Medical University	OPTOMETRY AND VISION SCIENCE	Sebaceous Carcinoma of Lacrimal Caruncle in a Chinese Patient
zhao dongqing	China:Huizhou First Hosp, Huizhou 516001,Peoples R China. 	BMC OPHTHALMOLOGY	Establishment of the mild, moderate and severe dry eye models using three methods in rabbits
zhao kanxing	China:Tianjin Med Univ, Tianjin Eye Hosp, Beijing 300070,Peoples R China. Tianjin Medical University	JOURNAL OF AAPOS	Surgical management of large-angle incomitant strabismus in patients with oculomotor nerve palsy
zhao ping	China:Hebei Med Univ, Hosp 4, Shijiazhuang 050011,Peoples R China. Hebei Medical University	INVESTIGATIVE OPHTHALMOLOGY & VISUAL SCIENCE	The Effects of Estrogen and Androgen on Tear Secretion and Matrix Metalloproteinase-2 Expression in Lacrimal Glands of Ovariectomized Rats
zhao ping	China:Univ So Calif, Dept Cell & Neurobiol, Keck Sch Med, Los Angeles, CA 90089 USA. University of Southern California	CORNEA	Changes of Chloride Channels in the Lacrimal Glands of a Rabbit Model of Sjogren Syndrome
zhao xia	China:First Peoples Hosp Dongcheng Dist, Dept Ophthalmol, Beijing,Peoples R China. 	INVESTIGATIVE OPHTHALMOLOGY & VISUAL SCIENCE	The Effects of Estrogen and Androgen on Tear Secretion and Matrix Metalloproteinase-2 Expression in Lacrimal Glands of Ovariectomized Rats
zhao yanyan	China:Cent S Univ, Inst Clin Pharmacol, Changsha 410083, Hunan,Peoples R China. Central South University	OCULAR IMMUNOLOGY AND INFLAMMATION	Granulomatosis with Polyangiitis: The Relationship Between Ocular and Nasal Disease
zhao yingying	China:Zhejiang Univ, Sch Med, Affiliated Hosp 2, Ctr Eye, Hangzhou 310009, Zhejiang,Peoples R China. Zhejiang University	OPHTHALMIC PLASTIC AND RECONSTRUCTIVE SURGERY	Use of Crawford Tube for Chronic Suppurative Lacrimal Canaliculitis
zhao yune	China:Wenzhou Med Coll, Affiliated Eye Hosp, Sch Ophthalmol & Optometry, Wenzhou 325027, Zhejiang,Peoples R China. Wenzhou Medical University	OPHTHALMIC EPIDEMIOLOGY	A Meta-analysis of Primary External Dacryocystorhinostomy With and Without Mitomycin C
zhong jingxiang	China:Jinan Univ, Affiliated Hosp 1, Dept Ophthalmol, Guangzhou 510632, Guangdong,Peoples R China. Jinan University	INTERNATIONAL JOURNAL OF OPHTHALMOLOGY	New mucosal flap modification for endonasal endoscopic dacryocystorhinostomy in Asians
zhou h	China:Shanghai Jiao Tong Univ, Sch Med, Shanghai Peoples Hosp 9, Dept Ophthalmol, Shanghai 200011,Peoples R China. Shanghai Jiao Tong University	EYE	The use of Medpor coated tear drainage tube in conjunctivodacryocystorhinostomy
zhou h	China:Shanghai Jiao Tong Univ, Sch Med, Shanghai Peoples Hosp 9, Dept Ophthalmol, Shanghai 200011,Peoples R China. Shanghai Jiao Tong University	OPHTHALMIC PLASTIC AND RECONSTRUCTIVE SURGERY	Palpebral Lipogranuloma Caused by Transcanalicular Ointment Injection After Laser Canaliculoplasty
zhou q	China:Tongji Univ, Dept Ophthalmol, Tongji Hosp, Sch Med, Shanghai 200092,Peoples R China. Tongji University	EYE	Two-step retrograde closed stenting: a novel method for treating canalicular lacerations in Chinese patients
zhou qiong	China:Nanchang Univ, Dept Ophthalmol, Affiliated Hosp 1, Nanchang 330006, Jiangxi,Peoples R China. Nanchang University	INTERNATIONAL JOURNAL OF OPHTHALMOLOGY	Aerocyst urethral catheter insertion compared to expansion sponges application in external dacryocystorhinostomy
zhu h	China:Cent S Univ, Xiangya Hosp 2, Dept Radiol, Changsha 410011,Peoples R China. Central South University	OPHTHALMOLOGICA	Adult nasolacrimal sac mucocele
zhu huian	China:Hunan Univ Tradit Chinese Med, Affiliated Hosp 1, Dept Ophthalmol, Changsha 410007, Hunan,Peoples R China. 	INTERNATIONAL JOURNAL OF OPHTHALMOLOGY	Effects of extract of Buddleja officinalis on partial inflammation of lacrimal gland in castrated rabbits with dry eye
zhu lei	China:Henan Eye Inst, Zhengzhou,Peoples R China. 	MOLECULAR VISION	Topical steroid and non-steroidal anti-inflammatory drugs inhibit inflammatory cytokine expression on the ocular surface in the botulium toxin B-induced murine dry eye model
zhu lei	China:Johns Hopkins Univ, Wilmer Eye Inst, Baltimore, MD 21117 USA. Johns Hopkins University	MOLECULAR VISION	Inflammatory cytokine expression on the ocular surface in the Botulium toxin B induced murine dry eye model
zou wj	China:Sun Yat Sen Univ, Ocular Surface Ctr, Zhongshan Ophthalm Ctr, State Key Lab Ophthalmol, Guangzhou,Peoples R China. Sun Yat Sen University	EXPERIMENTAL EYE RESEARCH	MUC19 expression in human ocular surface and lacrimal gland and its alteration in Sjogren syndrome patients
